,Date,Home Team,Visitor Team,Home Team Score,Visitor Team Score,Point Difference,Home Win,Home Loss
0,2020-12-22T00:00:00.000Z,Brooklyn Nets,Golden State Warriors,125,99,26,1,0
1,2020-12-22T00:00:00.000Z,Los Angeles Lakers,LA Clippers,109,116,-7,0,1
2,2020-12-25T00:00:00.000Z,Miami Heat,New Orleans Pelicans,111,98,13,1,0
3,2020-12-26T00:00:00.000Z,Washington Wizards,Orlando Magic,120,130,-10,0,1
4,2020-12-23T00:00:00.000Z,Cleveland Cavaliers,Charlotte Hornets,121,114,7,1,0
5,2020-12-23T00:00:00.000Z,Minnesota Timberwolves,Detroit Pistons,111,101,10,1,0
6,2020-12-25T00:00:00.000Z,Milwaukee Bucks,Golden State Warriors,138,99,39,1,0
7,2020-12-23T00:00:00.000Z,Indiana Pacers,New York Knicks,121,107,14,1,0
8,2020-12-23T00:00:00.000Z,Orlando Magic,Miami Heat,113,107,6,1,0
9,2020-12-23T00:00:00.000Z,Denver Nuggets,Sacramento Kings,122,124,-2,0,1
10,2020-12-23T00:00:00.000Z,Portland Trail Blazers,Utah Jazz,100,120,-20,0,1
11,2020-12-23T00:00:00.000Z,Philadelphia 76ers,Washington Wizards,113,107,6,1,0
12,2020-12-25T00:00:00.000Z,Boston Celtics,Brooklyn Nets,95,123,-28,0,1
13,2020-12-25T00:00:00.000Z,Los Angeles Lakers,Dallas Mavericks,138,115,23,1,0
14,2020-12-25T00:00:00.000Z,Denver Nuggets,LA Clippers,108,121,-13,0,1
15,2020-12-23T00:00:00.000Z,Boston Celtics,Milwaukee Bucks,122,121,1,1,0
16,2020-12-23T00:00:00.000Z,Chicago Bulls,Atlanta Hawks,104,124,-20,0,1
17,2020-12-26T00:00:00.000Z,Memphis Grizzlies,Atlanta Hawks,112,122,-10,0,1
18,2020-12-23T00:00:00.000Z,Memphis Grizzlies,San Antonio Spurs,119,131,-12,0,1
19,2020-12-23T00:00:00.000Z,Toronto Raptors,New Orleans Pelicans,99,113,-14,0,1
20,2020-12-23T00:00:00.000Z,Phoenix Suns,Dallas Mavericks,106,102,4,1,0
21,2020-12-26T00:00:00.000Z,Charlotte Hornets,Oklahoma City Thunder,107,109,-2,0,1
22,2020-12-26T00:00:00.000Z,Detroit Pistons,Cleveland Cavaliers,119,128,-9,0,1
23,2020-12-26T00:00:00.000Z,New York Knicks,Philadelphia 76ers,89,109,-20,0,1
24,2020-12-26T00:00:00.000Z,Chicago Bulls,Indiana Pacers,106,125,-19,0,1
25,2020-12-26T00:00:00.000Z,San Antonio Spurs,Toronto Raptors,119,114,5,1,0
26,2020-12-26T00:00:00.000Z,Utah Jazz,Minnesota Timberwolves,111,116,-5,0,1
27,2020-12-26T00:00:00.000Z,Sacramento Kings,Phoenix Suns,106,103,3,1,0
28,2020-12-26T00:00:00.000Z,Portland Trail Blazers,Houston Rockets,128,126,2,1,0
29,2020-12-29T00:00:00.000Z,Washington Wizards,Chicago Bulls,107,115,-8,0,1
30,2020-12-29T00:00:00.000Z,Oklahoma City Thunder,Orlando Magic,107,118,-11,0,1
31,2020-12-27T00:00:00.000Z,Sacramento Kings,Phoenix Suns,100,116,-16,0,1
32,2020-12-27T00:00:00.000Z,Cleveland Cavaliers,Philadelphia 76ers,118,94,24,1,0
33,2020-12-27T00:00:00.000Z,Los Angeles Lakers,Minnesota Timberwolves,127,91,36,1,0
34,2020-12-27T00:00:00.000Z,Chicago Bulls,Golden State Warriors,128,129,-1,0,1
35,2020-12-29T00:00:00.000Z,LA Clippers,Minnesota Timberwolves,124,101,23,1,0
36,2020-12-27T00:00:00.000Z,Indiana Pacers,Boston Celtics,108,107,1,1,0
37,2020-12-29T00:00:00.000Z,Phoenix Suns,New Orleans Pelicans,111,86,25,1,0
38,2020-12-27T00:00:00.000Z,New York Knicks,Milwaukee Bucks,130,110,20,1,0
39,2020-12-27T00:00:00.000Z,LA Clippers,Dallas Mavericks,73,124,-51,0,1
40,2020-12-27T00:00:00.000Z,Charlotte Hornets,Brooklyn Nets,106,104,2,1,0
41,2020-12-27T00:00:00.000Z,Washington Wizards,Orlando Magic,113,120,-7,0,1
42,2020-12-27T00:00:00.000Z,New Orleans Pelicans,San Antonio Spurs,98,95,3,1,0
43,2020-12-29T00:00:00.000Z,Philadelphia 76ers,Toronto Raptors,100,93,7,1,0
44,2020-12-28T00:00:00.000Z,Atlanta Hawks,Detroit Pistons,128,120,8,1,0
45,2020-12-28T00:00:00.000Z,Brooklyn Nets,Memphis Grizzlies,111,116,-5,0,1
46,2020-12-28T00:00:00.000Z,Oklahoma City Thunder,Utah Jazz,109,110,-1,0,1
47,2020-12-28T00:00:00.000Z,Denver Nuggets,Houston Rockets,124,111,13,1,0
48,2020-12-28T00:00:00.000Z,Los Angeles Lakers,Portland Trail Blazers,107,115,-8,0,1
49,2021-01-17T00:00:00.000Z,Washington Wizards,Cleveland Cavaliers,119,110,9,1,0
50,2021-01-04T00:00:00.000Z,Philadelphia 76ers,Charlotte Hornets,118,101,17,1,0
51,2021-01-15T00:00:00.000Z,Oklahoma City Thunder,Chicago Bulls,127,125,2,1,0
52,2021-01-29T00:00:00.000Z,Charlotte Hornets,Indiana Pacers,108,105,3,1,0
53,2020-12-30T00:00:00.000Z,LA Clippers,Portland Trail Blazers,128,105,23,1,0
54,2021-01-30T00:00:00.000Z,Boston Celtics,Los Angeles Lakers,95,96,-1,0,1
55,2021-01-31T00:00:00.000Z,New York Knicks,LA Clippers,115,129,-14,0,1
56,2021-01-03T00:00:00.000Z,Memphis Grizzlies,Los Angeles Lakers,94,108,-14,0,1
57,2021-01-07T00:00:00.000Z,Memphis Grizzlies,Cleveland Cavaliers,90,94,-4,0,1
58,2021-02-26T00:00:00.000Z,Detroit Pistons,Sacramento Kings,107,110,-3,0,1
59,2021-01-01T00:00:00.000Z,Dallas Mavericks,Miami Heat,93,83,10,1,0
60,2021-01-09T00:00:00.000Z,Dallas Mavericks,Orlando Magic,112,98,14,1,0
61,2021-01-02T00:00:00.000Z,Philadelphia 76ers,Charlotte Hornets,127,112,15,1,0
62,2021-02-06T00:00:00.000Z,Cleveland Cavaliers,Milwaukee Bucks,99,124,-25,0,1
63,2021-01-10T00:00:00.000Z,Brooklyn Nets,Oklahoma City Thunder,116,129,-13,0,1
64,2020-12-29T00:00:00.000Z,Detroit Pistons,Golden State Warriors,106,116,-10,0,1
65,2020-12-31T00:00:00.000Z,Indiana Pacers,Cleveland Cavaliers,119,99,20,1,0
66,2021-01-11T00:00:00.000Z,Washington Wizards,Phoenix Suns,128,107,21,1,0
67,2021-01-18T00:00:00.000Z,Miami Heat,Detroit Pistons,113,107,6,1,0
68,2021-02-17T00:00:00.000Z,Philadelphia 76ers,Houston Rockets,118,113,5,1,0
69,2021-03-04T00:00:00.000Z,Washington Wizards,LA Clippers,119,117,2,1,0
70,2021-01-06T00:00:00.000Z,New York Knicks,Utah Jazz,112,100,12,1,0
71,2021-02-03T00:00:00.000Z,Oklahoma City Thunder,Houston Rockets,104,87,17,1,0
72,2021-02-05T00:00:00.000Z,Orlando Magic,Chicago Bulls,123,119,4,1,0
73,2021-01-22T00:00:00.000Z,Philadelphia 76ers,Boston Celtics,122,110,12,1,0
74,2021-01-08T00:00:00.000Z,Detroit Pistons,Phoenix Suns,110,105,5,1,0
75,2021-01-22T00:00:00.000Z,Sacramento Kings,New York Knicks,103,94,9,1,0
76,2021-01-27T00:00:00.000Z,Atlanta Hawks,Brooklyn Nets,128,132,-4,0,1
77,2021-01-27T00:00:00.000Z,Utah Jazz,Dallas Mavericks,116,104,12,1,0
78,2021-02-15T00:00:00.000Z,Golden State Warriors,Cleveland Cavaliers,129,98,31,1,0
79,2021-02-10T00:00:00.000Z,Los Angeles Lakers,Oklahoma City Thunder,114,113,1,1,0
80,2021-02-25T00:00:00.000Z,Denver Nuggets,Washington Wizards,110,112,-2,0,1
81,2021-01-20T00:00:00.000Z,Houston Rockets,Phoenix Suns,103,109,-6,0,1
82,2021-02-04T00:00:00.000Z,Los Angeles Lakers,Denver Nuggets,114,93,21,1,0
83,2021-02-16T00:00:00.000Z,Milwaukee Bucks,Toronto Raptors,113,124,-11,0,1
84,2021-01-23T00:00:00.000Z,Utah Jazz,Golden State Warriors,127,108,19,1,0
85,2021-01-16T00:00:00.000Z,Phoenix Suns,Indiana Pacers,111,122,-11,0,1
86,2021-02-24T00:00:00.000Z,New Orleans Pelicans,Detroit Pistons,128,118,10,1,0
87,2021-02-19T00:00:00.000Z,Minnesota Timberwolves,Toronto Raptors,81,86,-5,0,1
88,2021-03-03T00:00:00.000Z,Minnesota Timberwolves,Charlotte Hornets,102,135,-33,0,1
89,2021-01-24T00:00:00.000Z,LA Clippers,Oklahoma City Thunder,108,100,8,1,0
90,2021-02-12T00:00:00.000Z,Chicago Bulls,LA Clippers,106,125,-19,0,1
91,2021-01-25T00:00:00.000Z,Brooklyn Nets,Miami Heat,98,85,13,1,0
92,2021-02-13T00:00:00.000Z,New York Knicks,Houston Rockets,121,99,22,1,0
93,2021-02-20T00:00:00.000Z,Memphis Grizzlies,Phoenix Suns,97,128,-31,0,1
94,2021-02-14T00:00:00.000Z,Toronto Raptors,Minnesota Timberwolves,112,116,-4,0,1
95,2021-02-21T00:00:00.000Z,New York Knicks,Minnesota Timberwolves,103,99,4,1,0
96,2021-02-22T00:00:00.000Z,Phoenix Suns,Portland Trail Blazers,132,100,32,1,0
97,2021-01-28T00:00:00.000Z,Detroit Pistons,Los Angeles Lakers,107,92,15,1,0
98,2021-02-23T00:00:00.000Z,New York Knicks,Golden State Warriors,106,114,-8,0,1
99,2021-02-01T00:00:00.000Z,Chicago Bulls,New York Knicks,110,102,8,1,0
100,2021-03-13T00:00:00.000Z,Denver Nuggets,Dallas Mavericks,103,116,-13,0,1
101,2021-03-17T00:00:00.000Z,Indiana Pacers,Brooklyn Nets,115,124,-9,0,1
102,2021-05-05T00:00:00.000Z,Orlando Magic,Boston Celtics,96,132,-36,0,1
103,2021-03-29T00:00:00.000Z,Brooklyn Nets,Minnesota Timberwolves,112,107,5,1,0
104,2021-04-06T00:00:00.000Z,Boston Celtics,Philadelphia 76ers,96,106,-10,0,1
105,2021-03-30T00:00:00.000Z,Denver Nuggets,Philadelphia 76ers,104,95,9,1,0
106,2021-04-05T00:00:00.000Z,Dallas Mavericks,Utah Jazz,111,103,8,1,0
107,2021-04-25T00:00:00.000Z,Brooklyn Nets,Phoenix Suns,128,119,9,1,0
108,2021-03-31T00:00:00.000Z,Detroit Pistons,Portland Trail Blazers,101,124,-23,0,1
109,2021-04-03T00:00:00.000Z,Miami Heat,Cleveland Cavaliers,115,101,14,1,0
110,2021-03-18T00:00:00.000Z,Phoenix Suns,Minnesota Timberwolves,119,123,-4,0,1
111,2021-04-04T00:00:00.000Z,Chicago Bulls,Brooklyn Nets,115,107,8,1,0
112,2021-03-19T00:00:00.000Z,Orlando Magic,Brooklyn Nets,121,113,8,1,0
113,2021-04-01T00:00:00.000Z,Brooklyn Nets,Charlotte Hornets,111,89,22,1,0
114,2021-03-21T00:00:00.000Z,Miami Heat,Indiana Pacers,106,109,-3,0,1
115,2021-03-20T00:00:00.000Z,Milwaukee Bucks,San Antonio Spurs,120,113,7,1,0
116,2021-04-02T00:00:00.000Z,Boston Celtics,Houston Rockets,118,102,16,1,0
117,2021-04-13T00:00:00.000Z,Utah Jazz,Oklahoma City Thunder,106,96,10,1,0
118,2021-03-22T00:00:00.000Z,Chicago Bulls,Utah Jazz,95,120,-25,0,1
119,2021-04-21T00:00:00.000Z,Indiana Pacers,Oklahoma City Thunder,122,116,6,1,0
120,2021-04-16T00:00:00.000Z,Houston Rockets,Denver Nuggets,99,128,-29,0,1
121,2021-04-12T00:00:00.000Z,Dallas Mavericks,Philadelphia 76ers,95,113,-18,0,1
122,2021-04-07T00:00:00.000Z,Indiana Pacers,Minnesota Timberwolves,141,137,4,1,0
123,2021-04-29T00:00:00.000Z,Indiana Pacers,Brooklyn Nets,113,130,-17,0,1
124,2021-04-26T00:00:00.000Z,Detroit Pistons,Atlanta Hawks,100,86,14,1,0
125,2021-04-20T00:00:00.000Z,New York Knicks,Charlotte Hornets,109,97,12,1,0
126,2021-04-14T00:00:00.000Z,Charlotte Hornets,Cleveland Cavaliers,90,103,-13,0,1
127,2021-05-07T00:00:00.000Z,Charlotte Hornets,Orlando Magic,122,112,10,1,0
128,2021-04-11T00:00:00.000Z,Denver Nuggets,Boston Celtics,87,105,-18,0,1
129,2021-04-24T00:00:00.000Z,New York Knicks,Toronto Raptors,120,103,17,1,0
130,2021-05-09T00:00:00.000Z,Charlotte Hornets,New Orleans Pelicans,110,112,-2,0,1
131,2021-05-02T00:00:00.000Z,Houston Rockets,New York Knicks,97,122,-25,0,1
132,2021-04-19T00:00:00.000Z,Los Angeles Lakers,Utah Jazz,97,111,-14,0,1
133,2021-04-28T00:00:00.000Z,Memphis Grizzlies,Portland Trail Blazers,109,130,-21,0,1
134,2021-05-14T00:00:00.000Z,Philadelphia 76ers,Orlando Magic,122,97,25,1,0
135,2021-05-04T00:00:00.000Z,Detroit Pistons,Charlotte Hornets,99,102,-3,0,1
136,2021-04-23T00:00:00.000Z,Atlanta Hawks,Miami Heat,118,103,15,1,0
137,2021-05-06T00:00:00.000Z,Indiana Pacers,Atlanta Hawks,133,126,7,1,0
138,2021-05-01T00:00:00.000Z,Cleveland Cavaliers,Miami Heat,107,124,-17,0,1
139,2021-05-08T00:00:00.000Z,Utah Jazz,Houston Rockets,124,116,8,1,0
140,2021-05-10T00:00:00.000Z,Memphis Grizzlies,New Orleans Pelicans,115,110,5,1,0
141,2021-05-15T00:00:00.000Z,Indiana Pacers,Los Angeles Lakers,115,122,-7,0,1
142,2021-05-13T00:00:00.000Z,Minnesota Timberwolves,Denver Nuggets,103,114,-11,0,1
143,2021-05-16T00:00:00.000Z,Atlanta Hawks,Houston Rockets,124,95,29,1,0
144,2021-03-20T00:00:00.000Z,Memphis Grizzlies,Golden State Warriors,111,103,8,1,0
145,2021-05-07T00:00:00.000Z,Philadelphia 76ers,New Orleans Pelicans,109,107,2,1,0
146,2021-03-15T00:00:00.000Z,Charlotte Hornets,Sacramento Kings,122,116,6,1,0
147,2021-03-14T00:00:00.000Z,New Orleans Pelicans,LA Clippers,135,115,20,1,0
148,2021-04-08T00:00:00.000Z,Oklahoma City Thunder,Cleveland Cavaliers,102,129,-27,0,1
149,2021-04-30T00:00:00.000Z,Boston Celtics,San Antonio Spurs,143,140,3,1,0
150,2021-04-26T00:00:00.000Z,Washington Wizards,San Antonio Spurs,143,146,-3,0,1
151,2021-04-03T00:00:00.000Z,Philadelphia 76ers,Minnesota Timberwolves,122,113,9,1,0
152,2021-03-19T00:00:00.000Z,Boston Celtics,Sacramento Kings,96,107,-11,0,1
153,2021-04-28T00:00:00.000Z,Philadelphia 76ers,Atlanta Hawks,127,83,44,1,0
154,2021-04-18T00:00:00.000Z,Atlanta Hawks,Indiana Pacers,129,117,12,1,0
155,2021-04-11T00:00:00.000Z,Orlando Magic,Milwaukee Bucks,87,124,-37,0,1
156,2021-04-09T00:00:00.000Z,Atlanta Hawks,Chicago Bulls,120,108,12,1,0
157,2021-03-23T00:00:00.000Z,Golden State Warriors,Philadelphia 76ers,98,108,-10,0,1
158,2021-04-13T00:00:00.000Z,Toronto Raptors,Atlanta Hawks,103,108,-5,0,1
159,2021-03-28T00:00:00.000Z,Denver Nuggets,Atlanta Hawks,126,102,24,1,0
160,2021-03-18T00:00:00.000Z,Portland Trail Blazers,New Orleans Pelicans,101,93,8,1,0
161,2021-04-16T00:00:00.000Z,Chicago Bulls,Memphis Grizzlies,115,126,-11,0,1
162,2021-04-20T00:00:00.000Z,Portland Trail Blazers,LA Clippers,112,113,-1,0,1
163,2021-03-22T00:00:00.000Z,San Antonio Spurs,Charlotte Hornets,97,100,-3,0,1
164,2021-03-17T00:00:00.000Z,Philadelphia 76ers,Milwaukee Bucks,105,109,-4,0,1
165,2021-04-02T00:00:00.000Z,New York Knicks,Dallas Mavericks,86,99,-13,0,1
166,2021-03-24T00:00:00.000Z,Indiana Pacers,Detroit Pistons,116,111,5,1,0
167,2021-04-14T00:00:00.000Z,Philadelphia 76ers,Brooklyn Nets,123,117,6,1,0
168,2021-04-05T00:00:00.000Z,San Antonio Spurs,Cleveland Cavaliers,101,125,-24,0,1
169,2021-04-23T00:00:00.000Z,Golden State Warriors,Denver Nuggets,118,97,21,1,0
170,2021-03-27T00:00:00.000Z,San Antonio Spurs,Chicago Bulls,120,104,16,1,0
171,2021-03-21T00:00:00.000Z,Denver Nuggets,New Orleans Pelicans,108,113,-5,0,1
172,2021-03-29T00:00:00.000Z,New York Knicks,Miami Heat,88,98,-10,0,1
173,2021-03-16T00:00:00.000Z,Chicago Bulls,Oklahoma City Thunder,123,102,21,1,0
174,2021-04-07T00:00:00.000Z,Orlando Magic,Washington Wizards,116,131,-15,0,1
175,2021-04-21T00:00:00.000Z,Toronto Raptors,Brooklyn Nets,114,103,11,1,0
176,2021-05-13T00:00:00.000Z,Phoenix Suns,Portland Trail Blazers,118,117,1,1,0
177,2021-04-24T00:00:00.000Z,Milwaukee Bucks,Philadelphia 76ers,132,94,38,1,0
178,2021-04-01T00:00:00.000Z,New Orleans Pelicans,Orlando Magic,110,115,-5,0,1
179,2021-03-26T00:00:00.000Z,Dallas Mavericks,Indiana Pacers,94,109,-15,0,1
180,2021-05-04T00:00:00.000Z,Milwaukee Bucks,Brooklyn Nets,124,118,6,1,0
181,2021-05-01T00:00:00.000Z,Houston Rockets,Golden State Warriors,87,113,-26,0,1
182,2021-04-04T00:00:00.000Z,LA Clippers,Los Angeles Lakers,104,86,18,1,0
183,2021-03-31T00:00:00.000Z,Memphis Grizzlies,Utah Jazz,107,111,-4,0,1
184,2021-04-12T00:00:00.000Z,Orlando Magic,San Antonio Spurs,97,120,-23,0,1
185,2021-05-08T00:00:00.000Z,Denver Nuggets,Brooklyn Nets,119,125,-6,0,1
186,2021-04-19T00:00:00.000Z,Boston Celtics,Chicago Bulls,96,102,-6,0,1
187,2021-04-06T00:00:00.000Z,Atlanta Hawks,New Orleans Pelicans,123,107,16,1,0
188,2021-04-17T00:00:00.000Z,Chicago Bulls,Cleveland Cavaliers,106,96,10,1,0
189,2021-05-05T00:00:00.000Z,Cleveland Cavaliers,Portland Trail Blazers,105,141,-36,0,1
190,2021-04-27T00:00:00.000Z,Golden State Warriors,Dallas Mavericks,103,133,-30,0,1
191,2021-04-29T00:00:00.000Z,Houston Rockets,Milwaukee Bucks,143,136,7,1,0
192,2021-05-02T00:00:00.000Z,Boston Celtics,Portland Trail Blazers,119,129,-10,0,1
193,2021-05-09T00:00:00.000Z,Cleveland Cavaliers,Dallas Mavericks,97,124,-27,0,1
194,2021-05-06T00:00:00.000Z,Detroit Pistons,Memphis Grizzlies,111,97,14,1,0
195,2021-05-03T00:00:00.000Z,Washington Wizards,Indiana Pacers,154,141,13,1,0
196,2021-05-10T00:00:00.000Z,San Antonio Spurs,Milwaukee Bucks,146,125,21,1,0
197,2021-05-11T00:00:00.000Z,Boston Celtics,Miami Heat,121,129,-8,0,1
198,2021-05-16T00:00:00.000Z,Toronto Raptors,Indiana Pacers,113,125,-12,0,1
199,2021-05-16T00:00:00.000Z,Brooklyn Nets,Cleveland Cavaliers,123,109,14,1,0
200,2021-05-15T00:00:00.000Z,New York Knicks,Charlotte Hornets,118,109,9,1,0
201,2021-05-05T00:00:00.000Z,Houston Rockets,Philadelphia 76ers,115,135,-20,0,1
202,2021-04-06T00:00:00.000Z,Indiana Pacers,Chicago Bulls,97,113,-16,0,1
203,2021-04-20T00:00:00.000Z,Sacramento Kings,Minnesota Timberwolves,120,134,-14,0,1
204,2021-04-01T00:00:00.000Z,Miami Heat,Golden State Warriors,116,109,7,1,0
205,2021-04-14T00:00:00.000Z,Minnesota Timberwolves,Milwaukee Bucks,105,130,-25,0,1
206,2021-04-07T00:00:00.000Z,Atlanta Hawks,Memphis Grizzlies,113,131,-18,0,1
207,2021-05-15T00:00:00.000Z,Milwaukee Bucks,Miami Heat,122,108,14,1,0
208,2021-05-04T00:00:00.000Z,Miami Heat,Dallas Mavericks,113,127,-14,0,1
209,2021-04-02T00:00:00.000Z,Memphis Grizzlies,Minnesota Timberwolves,120,108,12,1,0
210,2021-03-17T00:00:00.000Z,Dallas Mavericks,LA Clippers,105,89,16,1,0
211,2021-04-18T00:00:00.000Z,New York Knicks,New Orleans Pelicans,122,112,10,1,0
212,2021-03-26T00:00:00.000Z,New Orleans Pelicans,Denver Nuggets,108,113,-5,0,1
213,2021-03-24T00:00:00.000Z,Orlando Magic,Phoenix Suns,112,111,1,1,0
214,2021-04-08T00:00:00.000Z,Utah Jazz,Portland Trail Blazers,122,103,19,1,0
215,2021-04-26T00:00:00.000Z,Philadelphia 76ers,Oklahoma City Thunder,121,90,31,1,0
216,2021-03-29T00:00:00.000Z,Washington Wizards,Indiana Pacers,132,124,8,1,0
217,2021-03-29T00:00:00.000Z,LA Clippers,Milwaukee Bucks,129,105,24,1,0
218,2021-05-03T00:00:00.000Z,Detroit Pistons,Orlando Magic,112,119,-7,0,1
219,2021-04-09T00:00:00.000Z,Boston Celtics,Minnesota Timberwolves,145,136,9,1,0
220,2021-04-27T00:00:00.000Z,Toronto Raptors,Brooklyn Nets,103,116,-13,0,1
221,2021-03-20T00:00:00.000Z,LA Clippers,Charlotte Hornets,125,98,27,1,0
222,2021-03-22T00:00:00.000Z,Memphis Grizzlies,Boston Celtics,132,126,6,1,0
223,2021-05-14T00:00:00.000Z,Oklahoma City Thunder,Utah Jazz,93,109,-16,0,1
224,2021-03-27T00:00:00.000Z,Minnesota Timberwolves,Houston Rockets,107,129,-22,0,1
225,2021-04-03T00:00:00.000Z,Sacramento Kings,Milwaukee Bucks,128,129,-1,0,1
226,2021-04-10T00:00:00.000Z,Golden State Warriors,Houston Rockets,125,109,16,1,0
227,2021-03-30T00:00:00.000Z,Washington Wizards,Charlotte Hornets,104,114,-10,0,1
228,2021-03-28T00:00:00.000Z,Los Angeles Lakers,Orlando Magic,96,93,3,1,0
229,2021-05-01T00:00:00.000Z,Utah Jazz,Toronto Raptors,106,102,4,1,0
230,2021-05-02T00:00:00.000Z,Charlotte Hornets,Miami Heat,111,121,-10,0,1
231,2021-04-11T00:00:00.000Z,Cleveland Cavaliers,New Orleans Pelicans,109,116,-7,0,1
232,2021-05-07T00:00:00.000Z,Miami Heat,Minnesota Timberwolves,121,112,9,1,0
233,2021-03-23T00:00:00.000Z,Miami Heat,Phoenix Suns,100,110,-10,0,1
234,2021-04-21T00:00:00.000Z,Philadelphia 76ers,Phoenix Suns,113,116,-3,0,1
235,2021-04-04T00:00:00.000Z,Atlanta Hawks,Golden State Warriors,117,111,6,1,0
236,2021-03-31T00:00:00.000Z,Indiana Pacers,Miami Heat,87,92,-5,0,1
237,2021-04-12T00:00:00.000Z,New Orleans Pelicans,Sacramento Kings,117,110,7,1,0
238,2021-05-13T00:00:00.000Z,Charlotte Hornets,LA Clippers,90,113,-23,0,1
239,2021-04-24T00:00:00.000Z,Denver Nuggets,Houston Rockets,129,116,13,1,0
240,2021-04-05T00:00:00.000Z,Minnesota Timberwolves,Sacramento Kings,116,106,10,1,0
241,2021-04-13T00:00:00.000Z,Indiana Pacers,LA Clippers,115,126,-11,0,1
242,2021-05-12T00:00:00.000Z,Cleveland Cavaliers,Boston Celtics,102,94,8,1,0
243,2021-04-28T00:00:00.000Z,Boston Celtics,Charlotte Hornets,120,111,9,1,0
244,2021-05-16T00:00:00.000Z,Golden State Warriors,Memphis Grizzlies,113,101,12,1,0
245,2021-04-16T00:00:00.000Z,Toronto Raptors,Orlando Magic,113,102,11,1,0
246,2021-04-17T00:00:00.000Z,Boston Celtics,Golden State Warriors,119,114,5,1,0
247,2021-05-11T00:00:00.000Z,Chicago Bulls,Brooklyn Nets,107,115,-8,0,1
248,2021-05-10T00:00:00.000Z,Golden State Warriors,Utah Jazz,119,116,3,1,0
249,2021-05-09T00:00:00.000Z,Sacramento Kings,Oklahoma City Thunder,126,98,28,1,0
250,2021-05-06T00:00:00.000Z,Dallas Mavericks,Brooklyn Nets,113,109,4,1,0
251,2021-01-22T00:00:00.000Z,Charlotte Hornets,Chicago Bulls,110,123,-13,0,1
252,2021-01-21T00:00:00.000Z,Golden State Warriors,New York Knicks,104,119,-15,0,1
253,2021-02-02T00:00:00.000Z,Brooklyn Nets,LA Clippers,124,120,4,1,0
254,2021-01-30T00:00:00.000Z,New Orleans Pelicans,Houston Rockets,112,126,-14,0,1
255,2021-01-09T00:00:00.000Z,Charlotte Hornets,Atlanta Hawks,113,105,8,1,0
256,2021-02-01T00:00:00.000Z,Cleveland Cavaliers,Minnesota Timberwolves,100,98,2,1,0
257,2021-02-10T00:00:00.000Z,Washington Wizards,Toronto Raptors,115,137,-22,0,1
258,2020-12-30T00:00:00.000Z,Brooklyn Nets,Atlanta Hawks,145,141,4,1,0
259,2021-02-07T00:00:00.000Z,New York Knicks,Miami Heat,103,109,-6,0,1
260,2021-01-17T00:00:00.000Z,Denver Nuggets,Utah Jazz,105,109,-4,0,1
261,2021-01-05T00:00:00.000Z,Memphis Grizzlies,Los Angeles Lakers,92,94,-2,0,1
262,2021-01-16T00:00:00.000Z,Brooklyn Nets,Orlando Magic,122,115,7,1,0
263,2021-01-13T00:00:00.000Z,Detroit Pistons,Milwaukee Bucks,101,110,-9,0,1
264,2021-01-29T00:00:00.000Z,New Orleans Pelicans,Milwaukee Bucks,131,126,5,1,0
265,2020-12-29T00:00:00.000Z,Cleveland Cavaliers,New York Knicks,86,95,-9,0,1
266,2021-01-04T00:00:00.000Z,Orlando Magic,Cleveland Cavaliers,103,83,20,1,0
267,2021-01-03T00:00:00.000Z,Detroit Pistons,Boston Celtics,120,122,-2,0,1
268,2021-01-08T00:00:00.000Z,Milwaukee Bucks,Utah Jazz,118,131,-13,0,1
269,2020-12-31T00:00:00.000Z,Houston Rockets,Sacramento Kings,122,119,3,1,0
270,2021-01-18T00:00:00.000Z,Washington Wizards,Cleveland Cavaliers,120,105,15,1,0
271,2021-01-02T00:00:00.000Z,Houston Rockets,Sacramento Kings,102,94,8,1,0
272,2021-01-01T00:00:00.000Z,Charlotte Hornets,Memphis Grizzlies,93,108,-15,0,1
273,2021-02-21T00:00:00.000Z,New Orleans Pelicans,Boston Celtics,120,115,5,1,0
274,2021-02-27T00:00:00.000Z,Philadelphia 76ers,Cleveland Cavaliers,109,112,-3,0,1
275,2021-03-04T00:00:00.000Z,Boston Celtics,Toronto Raptors,132,125,7,1,0
276,2021-01-27T00:00:00.000Z,Charlotte Hornets,Indiana Pacers,106,116,-10,0,1
277,2021-02-09T00:00:00.000Z,Detroit Pistons,Brooklyn Nets,122,111,11,1,0
278,2021-01-06T00:00:00.000Z,Indiana Pacers,Houston Rockets,114,107,7,1,0
279,2021-01-10T00:00:00.000Z,Detroit Pistons,Utah Jazz,86,96,-10,0,1
280,2021-01-11T00:00:00.000Z,Charlotte Hornets,New York Knicks,109,88,21,1,0
281,2021-02-12T00:00:00.000Z,Charlotte Hornets,Minnesota Timberwolves,120,114,6,1,0
282,2021-02-04T00:00:00.000Z,Philadelphia 76ers,Portland Trail Blazers,105,121,-16,0,1
283,2021-02-12T00:00:00.000Z,Sacramento Kings,Orlando Magic,112,123,-11,0,1
284,2021-02-06T00:00:00.000Z,Sacramento Kings,Denver Nuggets,119,114,5,1,0
285,2021-03-02T00:00:00.000Z,Washington Wizards,Memphis Grizzlies,111,125,-14,0,1
286,2021-01-26T00:00:00.000Z,Houston Rockets,Washington Wizards,107,88,19,1,0
287,2021-01-25T00:00:00.000Z,Detroit Pistons,Philadelphia 76ers,119,104,15,1,0
288,2021-01-24T00:00:00.000Z,Indiana Pacers,Toronto Raptors,102,107,-5,0,1
289,2021-02-16T00:00:00.000Z,Boston Celtics,Denver Nuggets,112,99,13,1,0
290,2021-01-20T00:00:00.000Z,Atlanta Hawks,Detroit Pistons,123,115,8,1,0
291,2021-01-23T00:00:00.000Z,Dallas Mavericks,Houston Rockets,108,133,-25,0,1
292,2021-02-24T00:00:00.000Z,Indiana Pacers,Golden State Warriors,107,111,-4,0,1
293,2021-02-03T00:00:00.000Z,Charlotte Hornets,Philadelphia 76ers,111,118,-7,0,1
294,2021-01-31T00:00:00.000Z,Denver Nuggets,Utah Jazz,128,117,11,1,0
295,2021-02-08T00:00:00.000Z,Charlotte Hornets,Houston Rockets,119,94,25,1,0
296,2021-02-20T00:00:00.000Z,Charlotte Hornets,Golden State Warriors,102,100,2,1,0
297,2021-02-14T00:00:00.000Z,Dallas Mavericks,Portland Trail Blazers,118,121,-3,0,1
298,2021-02-05T00:00:00.000Z,Charlotte Hornets,Utah Jazz,121,138,-17,0,1
299,2021-02-28T00:00:00.000Z,Milwaukee Bucks,LA Clippers,105,100,5,1,0
300,2021-02-15T00:00:00.000Z,Indiana Pacers,Chicago Bulls,112,120,-8,0,1
301,2021-02-26T00:00:00.000Z,Miami Heat,Utah Jazz,124,116,8,1,0
302,2021-02-22T00:00:00.000Z,Indiana Pacers,San Antonio Spurs,94,109,-15,0,1
303,2021-02-23T00:00:00.000Z,Cleveland Cavaliers,Atlanta Hawks,112,111,1,1,0
304,2021-02-11T00:00:00.000Z,Detroit Pistons,Indiana Pacers,95,111,-16,0,1
305,2021-02-13T00:00:00.000Z,Phoenix Suns,Philadelphia 76ers,120,111,9,1,0
306,2021-02-19T00:00:00.000Z,Boston Celtics,Atlanta Hawks,121,109,12,1,0
307,2021-03-03T00:00:00.000Z,Cleveland Cavaliers,Indiana Pacers,111,114,-3,0,1
308,2021-03-01T00:00:00.000Z,Orlando Magic,Dallas Mavericks,124,130,-6,0,1
309,2021-02-25T00:00:00.000Z,Philadelphia 76ers,Dallas Mavericks,111,97,14,1,0
310,2021-02-17T00:00:00.000Z,Charlotte Hornets,Chicago Bulls,99,120,-21,0,1
311,2021-01-15T00:00:00.000Z,Detroit Pistons,Washington Wizards,120,91,29,1,0
312,2021-03-02T00:00:00.000Z,Milwaukee Bucks,Denver Nuggets,97,128,-31,0,1
313,2021-03-01T00:00:00.000Z,Houston Rockets,Cleveland Cavaliers,90,101,-11,0,1
314,2021-02-28T00:00:00.000Z,Boston Celtics,Washington Wizards,111,110,1,1,0
315,2021-02-27T00:00:00.000Z,Brooklyn Nets,Dallas Mavericks,98,115,-17,0,1
316,2021-02-03T00:00:00.000Z,San Antonio Spurs,Minnesota Timberwolves,111,108,3,1,0
317,2021-01-22T00:00:00.000Z,San Antonio Spurs,Dallas Mavericks,117,122,-5,0,1
318,2021-01-07T00:00:00.000Z,Denver Nuggets,Dallas Mavericks,117,124,-7,0,1
319,2021-02-23T00:00:00.000Z,Toronto Raptors,Philadelphia 76ers,102,109,-7,0,1
320,2021-02-06T00:00:00.000Z,Philadelphia 76ers,Brooklyn Nets,124,108,16,1,0
321,2021-01-24T00:00:00.000Z,Orlando Magic,Charlotte Hornets,104,107,-3,0,1
322,2021-01-06T00:00:00.000Z,Milwaukee Bucks,Detroit Pistons,130,115,15,1,0
323,2021-03-02T00:00:00.000Z,Miami Heat,Atlanta Hawks,80,94,-14,0,1
324,2021-02-24T00:00:00.000Z,Phoenix Suns,Charlotte Hornets,121,124,-3,0,1
325,2021-02-14T00:00:00.000Z,Charlotte Hornets,San Antonio Spurs,110,122,-12,0,1
326,2021-01-25T00:00:00.000Z,Indiana Pacers,Toronto Raptors,129,114,15,1,0
327,2021-01-27T00:00:00.000Z,New Orleans Pelicans,Washington Wizards,124,106,18,1,0
328,2021-01-09T00:00:00.000Z,Philadelphia 76ers,Denver Nuggets,103,115,-12,0,1
329,2021-02-21T00:00:00.000Z,LA Clippers,Brooklyn Nets,108,112,-4,0,1
330,2021-01-28T00:00:00.000Z,Houston Rockets,Portland Trail Blazers,104,101,3,1,0
331,2021-02-27T00:00:00.000Z,Oklahoma City Thunder,Denver Nuggets,96,126,-30,0,1
332,2021-01-04T00:00:00.000Z,Miami Heat,Oklahoma City Thunder,118,90,28,1,0
333,2021-01-03T00:00:00.000Z,Phoenix Suns,LA Clippers,107,112,-5,0,1
334,2021-01-01T00:00:00.000Z,Denver Nuggets,Phoenix Suns,103,106,-3,0,1
335,2020-12-29T00:00:00.000Z,Indiana Pacers,Boston Celtics,111,116,-5,0,1
336,2021-02-15T00:00:00.000Z,Sacramento Kings,Brooklyn Nets,106,136,-30,0,1
337,2021-02-12T00:00:00.000Z,Denver Nuggets,Oklahoma City Thunder,97,95,2,1,0
338,2021-01-19T00:00:00.000Z,Utah Jazz,New Orleans Pelicans,118,102,16,1,0
339,2021-01-10T00:00:00.000Z,Minnesota Timberwolves,San Antonio Spurs,96,88,8,1,0
340,2021-02-01T00:00:00.000Z,Oklahoma City Thunder,Houston Rockets,106,136,-30,0,1
341,2021-01-08T00:00:00.000Z,Boston Celtics,Washington Wizards,116,107,9,1,0
342,2021-01-23T00:00:00.000Z,Chicago Bulls,Los Angeles Lakers,90,101,-11,0,1
343,2021-02-09T00:00:00.000Z,Utah Jazz,Boston Celtics,122,108,14,1,0
344,2021-01-20T00:00:00.000Z,Charlotte Hornets,Washington Wizards,119,97,22,1,0
345,2021-02-10T00:00:00.000Z,Memphis Grizzlies,Charlotte Hornets,130,114,16,1,0
346,2021-01-15T00:00:00.000Z,Milwaukee Bucks,Dallas Mavericks,112,109,3,1,0
347,2021-01-29T00:00:00.000Z,Washington Wizards,Atlanta Hawks,100,116,-16,0,1
348,2021-02-05T00:00:00.000Z,Oklahoma City Thunder,Minnesota Timberwolves,103,106,-3,0,1
349,2021-03-03T00:00:00.000Z,Philadelphia 76ers,Utah Jazz,131,123,8,1,0
350,2021-01-18T00:00:00.000Z,Toronto Raptors,Dallas Mavericks,116,93,23,1,0
351,2021-02-28T00:00:00.000Z,Miami Heat,Atlanta Hawks,109,99,10,1,0
352,2021-03-04T00:00:00.000Z,San Antonio Spurs,Oklahoma City Thunder,102,107,-5,0,1
353,2021-02-22T00:00:00.000Z,Utah Jazz,Charlotte Hornets,132,110,22,1,0
354,2021-01-30T00:00:00.000Z,Golden State Warriors,Detroit Pistons,118,91,27,1,0
355,2021-02-13T00:00:00.000Z,Golden State Warriors,Brooklyn Nets,117,134,-17,0,1
356,2021-02-16T00:00:00.000Z,Oklahoma City Thunder,Portland Trail Blazers,104,115,-11,0,1
357,2021-02-17T00:00:00.000Z,Boston Celtics,Atlanta Hawks,114,122,-8,0,1
358,2021-02-08T00:00:00.000Z,Denver Nuggets,Milwaukee Bucks,112,125,-13,0,1
359,2021-02-26T00:00:00.000Z,Oklahoma City Thunder,Atlanta Hawks,118,109,9,1,0
360,2021-03-01T00:00:00.000Z,Chicago Bulls,Denver Nuggets,112,118,-6,0,1
361,2021-02-19T00:00:00.000Z,Houston Rockets,Dallas Mavericks,102,93,9,1,0
362,2020-12-31T00:00:00.000Z,Toronto Raptors,New York Knicks,100,83,17,1,0
363,2021-01-09T00:00:00.000Z,Indiana Pacers,Phoenix Suns,117,125,-8,0,1
364,2021-01-05T00:00:00.000Z,LA Clippers,San Antonio Spurs,113,116,-3,0,1
365,2021-01-01T00:00:00.000Z,Milwaukee Bucks,Chicago Bulls,126,96,30,1,0
366,2021-01-15T00:00:00.000Z,Cleveland Cavaliers,New York Knicks,106,103,3,1,0
367,2021-01-22T00:00:00.000Z,Cleveland Cavaliers,Brooklyn Nets,125,113,12,1,0
368,2021-01-03T00:00:00.000Z,Brooklyn Nets,Washington Wizards,122,123,-1,0,1
369,2021-01-02T00:00:00.000Z,Orlando Magic,Oklahoma City Thunder,99,108,-9,0,1
370,2021-01-04T00:00:00.000Z,Toronto Raptors,Boston Celtics,114,126,-12,0,1
371,2021-02-01T00:00:00.000Z,Atlanta Hawks,Los Angeles Lakers,99,107,-8,0,1
372,2020-12-30T00:00:00.000Z,Miami Heat,Milwaukee Bucks,119,108,11,1,0
373,2021-02-12T00:00:00.000Z,Washington Wizards,New York Knicks,91,109,-18,0,1
374,2021-01-08T00:00:00.000Z,Golden State Warriors,LA Clippers,115,105,10,1,0
375,2021-02-14T00:00:00.000Z,Boston Celtics,Detroit Pistons,102,108,-6,0,1
376,2020-12-29T00:00:00.000Z,Miami Heat,Milwaukee Bucks,97,144,-47,0,1
377,2021-02-11T00:00:00.000Z,Houston Rockets,Miami Heat,94,101,-7,0,1
378,2021-01-10T00:00:00.000Z,New York Knicks,Denver Nuggets,89,114,-25,0,1
379,2021-01-11T00:00:00.000Z,Orlando Magic,Milwaukee Bucks,99,121,-22,0,1
380,2021-01-16T00:00:00.000Z,Memphis Grizzlies,Philadelphia 76ers,106,104,2,1,0
381,2021-01-25T00:00:00.000Z,Dallas Mavericks,Denver Nuggets,113,117,-4,0,1
382,2021-01-06T00:00:00.000Z,Orlando Magic,Cleveland Cavaliers,105,94,11,1,0
383,2021-01-29T00:00:00.000Z,San Antonio Spurs,Denver Nuggets,119,109,10,1,0
384,2021-01-18T00:00:00.000Z,Memphis Grizzlies,Phoenix Suns,108,104,4,1,0
385,2021-01-17T00:00:00.000Z,Boston Celtics,New York Knicks,75,105,-30,0,1
386,2021-02-02T00:00:00.000Z,Utah Jazz,Detroit Pistons,117,105,12,1,0
387,2021-02-21T00:00:00.000Z,Cleveland Cavaliers,Oklahoma City Thunder,101,117,-16,0,1
388,2021-01-30T00:00:00.000Z,Chicago Bulls,Portland Trail Blazers,122,123,-1,0,1
389,2021-02-22T00:00:00.000Z,Houston Rockets,Chicago Bulls,100,120,-20,0,1
390,2021-01-20T00:00:00.000Z,Toronto Raptors,Miami Heat,102,111,-9,0,1
391,2021-02-23T00:00:00.000Z,Brooklyn Nets,Sacramento Kings,127,118,9,1,0
392,2021-02-03T00:00:00.000Z,Cleveland Cavaliers,LA Clippers,99,121,-22,0,1
393,2021-02-05T00:00:00.000Z,Indiana Pacers,New Orleans Pelicans,113,114,-1,0,1
394,2021-02-07T00:00:00.000Z,Phoenix Suns,Boston Celtics,100,91,9,1,0
395,2021-01-31T00:00:00.000Z,Toronto Raptors,Orlando Magic,115,102,13,1,0
396,2021-02-04T00:00:00.000Z,Atlanta Hawks,Utah Jazz,91,112,-21,0,1
397,2021-02-06T00:00:00.000Z,Orlando Magic,Chicago Bulls,92,118,-26,0,1
398,2021-02-24T00:00:00.000Z,Atlanta Hawks,Boston Celtics,127,112,15,1,0
399,2021-02-25T00:00:00.000Z,Brooklyn Nets,Orlando Magic,129,92,37,1,0
400,2021-02-08T00:00:00.000Z,Chicago Bulls,Washington Wizards,101,105,-4,0,1
401,2021-02-26T00:00:00.000Z,Chicago Bulls,Phoenix Suns,97,106,-9,0,1
402,2021-02-27T00:00:00.000Z,New York Knicks,Indiana Pacers,110,107,3,1,0
403,2021-02-09T00:00:00.000Z,Miami Heat,New York Knicks,98,96,2,1,0
404,2021-02-19T00:00:00.000Z,Memphis Grizzlies,Detroit Pistons,109,95,14,1,0
405,2021-02-10T00:00:00.000Z,Brooklyn Nets,Indiana Pacers,104,94,10,1,0
406,2021-02-15T00:00:00.000Z,New York Knicks,Atlanta Hawks,123,112,11,1,0
407,2021-02-20T00:00:00.000Z,Houston Rockets,Indiana Pacers,124,132,-8,0,1
408,2021-01-27T00:00:00.000Z,Memphis Grizzlies,Chicago Bulls,101,90,11,1,0
409,2021-02-28T00:00:00.000Z,Toronto Raptors,Chicago Bulls,113,122,-9,0,1
410,2021-02-13T00:00:00.000Z,Atlanta Hawks,Indiana Pacers,113,125,-12,0,1
411,2021-03-04T00:00:00.000Z,Indiana Pacers,Denver Nuggets,103,113,-10,0,1
412,2021-03-01T00:00:00.000Z,Philadelphia 76ers,Indiana Pacers,130,114,16,1,0
413,2021-03-02T00:00:00.000Z,Boston Celtics,LA Clippers,117,112,5,1,0
414,2021-03-03T00:00:00.000Z,Orlando Magic,Atlanta Hawks,112,115,-3,0,1
415,2021-02-17T00:00:00.000Z,Cleveland Cavaliers,San Antonio Spurs,110,116,-6,0,1
416,2021-02-16T00:00:00.000Z,Detroit Pistons,San Antonio Spurs,99,109,-10,0,1
417,2021-02-26T00:00:00.000Z,Los Angeles Lakers,Portland Trail Blazers,102,93,9,1,0
418,2020-12-31T00:00:00.000Z,Oklahoma City Thunder,New Orleans Pelicans,80,113,-33,0,1
419,2021-01-21T00:00:00.000Z,Milwaukee Bucks,Los Angeles Lakers,106,113,-7,0,1
420,2021-01-06T00:00:00.000Z,Phoenix Suns,Toronto Raptors,123,115,8,1,0
421,2021-02-07T00:00:00.000Z,Indiana Pacers,Utah Jazz,95,103,-8,0,1
422,2021-01-03T00:00:00.000Z,Chicago Bulls,Dallas Mavericks,118,108,10,1,0
423,2021-01-28T00:00:00.000Z,Phoenix Suns,Golden State Warriors,114,93,21,1,0
424,2021-01-29T00:00:00.000Z,New York Knicks,Cleveland Cavaliers,102,81,21,1,0
425,2020-12-29T00:00:00.000Z,Sacramento Kings,Denver Nuggets,125,115,10,1,0
426,2021-02-28T00:00:00.000Z,Sacramento Kings,Charlotte Hornets,126,127,-1,0,1
427,2021-02-08T00:00:00.000Z,Dallas Mavericks,Minnesota Timberwolves,127,122,5,1,0
428,2021-01-22T00:00:00.000Z,Indiana Pacers,Orlando Magic,120,118,2,1,0
429,2021-01-22T00:00:00.000Z,LA Clippers,Oklahoma City Thunder,120,106,14,1,0
430,2021-01-02T00:00:00.000Z,New Orleans Pelicans,Toronto Raptors,120,116,4,1,0
431,2021-01-07T00:00:00.000Z,Portland Trail Blazers,Minnesota Timberwolves,135,117,18,1,0
432,2021-01-01T00:00:00.000Z,San Antonio Spurs,Los Angeles Lakers,103,109,-6,0,1
433,2021-01-27T00:00:00.000Z,Miami Heat,Denver Nuggets,82,109,-27,0,1
434,2021-01-27T00:00:00.000Z,Phoenix Suns,Oklahoma City Thunder,97,102,-5,0,1
435,2020-12-30T00:00:00.000Z,Boston Celtics,Memphis Grizzlies,126,107,19,1,0
436,2021-02-18T00:00:00.000Z,Los Angeles Lakers,Brooklyn Nets,98,109,-11,0,1
437,2021-01-20T00:00:00.000Z,Philadelphia 76ers,Boston Celtics,117,109,8,1,0
438,2021-01-04T00:00:00.000Z,New Orleans Pelicans,Indiana Pacers,116,118,-2,0,1
439,2021-01-18T00:00:00.000Z,Los Angeles Lakers,Golden State Warriors,113,115,-2,0,1
440,2021-02-10T00:00:00.000Z,Denver Nuggets,Cleveland Cavaliers,133,95,38,1,0
441,2021-01-23T00:00:00.000Z,Brooklyn Nets,Miami Heat,128,124,4,1,0
442,2021-02-09T00:00:00.000Z,Portland Trail Blazers,Orlando Magic,106,97,9,1,0
443,2021-03-03T00:00:00.000Z,Sacramento Kings,Los Angeles Lakers,123,120,3,1,0
444,2021-01-08T00:00:00.000Z,Houston Rockets,Orlando Magic,132,90,42,1,0
445,2021-01-24T00:00:00.000Z,San Antonio Spurs,Washington Wizards,121,101,20,1,0
446,2021-02-19T00:00:00.000Z,Philadelphia 76ers,Chicago Bulls,112,105,7,1,0
447,2021-02-12T00:00:00.000Z,Utah Jazz,Milwaukee Bucks,129,115,14,1,0
448,2021-01-25T00:00:00.000Z,Cleveland Cavaliers,Los Angeles Lakers,108,115,-7,0,1
449,2021-02-02T00:00:00.000Z,Orlando Magic,Toronto Raptors,108,123,-15,0,1
450,2021-02-03T00:00:00.000Z,Miami Heat,Washington Wizards,100,103,-3,0,1
451,2021-02-14T00:00:00.000Z,Phoenix Suns,Orlando Magic,109,90,19,1,0
452,2021-02-21T00:00:00.000Z,Milwaukee Bucks,Sacramento Kings,128,115,13,1,0
453,2021-02-20T00:00:00.000Z,Portland Trail Blazers,Washington Wizards,111,118,-7,0,1
454,2021-02-01T00:00:00.000Z,Denver Nuggets,Detroit Pistons,134,119,15,1,0
455,2021-02-06T00:00:00.000Z,Dallas Mavericks,Golden State Warriors,134,132,2,1,0
456,2021-02-17T00:00:00.000Z,Dallas Mavericks,Detroit Pistons,127,117,10,1,0
457,2021-02-23T00:00:00.000Z,Denver Nuggets,Portland Trail Blazers,111,106,5,1,0
458,2021-02-24T00:00:00.000Z,Utah Jazz,Los Angeles Lakers,114,89,25,1,0
459,2021-01-20T00:00:00.000Z,Portland Trail Blazers,Memphis Grizzlies,128,130,-2,0,1
460,2021-01-15T00:00:00.000Z,Minnesota Timberwolves,Memphis Grizzlies,135,139,-4,0,1
461,2021-01-11T00:00:00.000Z,Cleveland Cavaliers,Memphis Grizzlies,91,101,-10,0,1
462,2021-01-21T00:00:00.000Z,Utah Jazz,New Orleans Pelicans,129,118,11,1,0
463,2021-02-10T00:00:00.000Z,Dallas Mavericks,Atlanta Hawks,118,117,1,1,0
464,2020-12-30T00:00:00.000Z,San Antonio Spurs,Los Angeles Lakers,107,121,-14,0,1
465,2021-01-09T00:00:00.000Z,Minnesota Timberwolves,San Antonio Spurs,122,125,-3,0,1
466,2020-12-31T00:00:00.000Z,Orlando Magic,Philadelphia 76ers,92,116,-24,0,1
467,2021-01-29T00:00:00.000Z,Oklahoma City Thunder,Brooklyn Nets,125,147,-22,0,1
468,2021-01-27T00:00:00.000Z,Cleveland Cavaliers,Detroit Pistons,122,107,15,1,0
469,2021-01-20T00:00:00.000Z,LA Clippers,Sacramento Kings,115,96,19,1,0
470,2021-01-06T00:00:00.000Z,Miami Heat,Boston Celtics,105,107,-2,0,1
471,2021-01-04T00:00:00.000Z,Golden State Warriors,Sacramento Kings,137,106,31,1,0
472,2021-01-06T00:00:00.000Z,Sacramento Kings,Chicago Bulls,128,124,4,1,0
473,2021-01-25T00:00:00.000Z,Chicago Bulls,Boston Celtics,103,119,-16,0,1
474,2021-02-16T00:00:00.000Z,Phoenix Suns,Brooklyn Nets,124,128,-4,0,1
475,2021-01-15T00:00:00.000Z,Boston Celtics,Orlando Magic,124,97,27,1,0
476,2021-02-06T00:00:00.000Z,Oklahoma City Thunder,Minnesota Timberwolves,120,118,2,1,0
477,2021-01-24T00:00:00.000Z,Boston Celtics,Cleveland Cavaliers,141,103,38,1,0
478,2021-02-08T00:00:00.000Z,Phoenix Suns,Cleveland Cavaliers,119,113,6,1,0
479,2021-02-26T00:00:00.000Z,Memphis Grizzlies,LA Clippers,99,119,-20,0,1
480,2021-01-01T00:00:00.000Z,Detroit Pistons,Boston Celtics,96,93,3,1,0
481,2021-01-05T00:00:00.000Z,Brooklyn Nets,Utah Jazz,130,96,34,1,0
482,2021-01-07T00:00:00.000Z,Brooklyn Nets,Philadelphia 76ers,122,109,13,1,0
483,2021-02-20T00:00:00.000Z,Chicago Bulls,Sacramento Kings,122,114,8,1,0
484,2021-02-22T00:00:00.000Z,Oklahoma City Thunder,Miami Heat,94,108,-14,0,1
485,2021-02-24T00:00:00.000Z,Chicago Bulls,Minnesota Timberwolves,133,126,7,1,0
486,2021-01-17T00:00:00.000Z,Sacramento Kings,New Orleans Pelicans,123,128,-5,0,1
487,2021-01-23T00:00:00.000Z,Phoenix Suns,Denver Nuggets,112,120,-8,0,1
488,2021-03-01T00:00:00.000Z,New Orleans Pelicans,Utah Jazz,129,124,5,1,0
489,2021-01-08T00:00:00.000Z,New Orleans Pelicans,Charlotte Hornets,110,118,-8,0,1
490,2021-02-12T00:00:00.000Z,Boston Celtics,Toronto Raptors,120,106,14,1,0
491,2021-02-11T00:00:00.000Z,Portland Trail Blazers,Philadelphia 76ers,118,114,4,1,0
492,2021-01-31T00:00:00.000Z,Indiana Pacers,Philadelphia 76ers,110,119,-9,0,1
493,2021-01-18T00:00:00.000Z,New York Knicks,Orlando Magic,91,84,7,1,0
494,2021-01-16T00:00:00.000Z,Toronto Raptors,Charlotte Hornets,116,113,3,1,0
495,2021-02-13T00:00:00.000Z,Utah Jazz,Miami Heat,112,94,18,1,0
496,2021-01-22T00:00:00.000Z,Detroit Pistons,Houston Rockets,102,103,-1,0,1
497,2021-02-04T00:00:00.000Z,Memphis Grizzlies,Houston Rockets,103,115,-12,0,1
498,2021-02-17T00:00:00.000Z,Minnesota Timberwolves,Indiana Pacers,128,134,-6,0,1
499,2021-02-17T00:00:00.000Z,LA Clippers,Utah Jazz,96,114,-18,0,1
500,2021-01-30T00:00:00.000Z,Miami Heat,Sacramento Kings,105,104,1,1,0
501,2021-02-19T00:00:00.000Z,Charlotte Hornets,Denver Nuggets,112,117,-5,0,1
502,2021-02-01T00:00:00.000Z,New Orleans Pelicans,Sacramento Kings,109,118,-9,0,1
503,2021-01-26T00:00:00.000Z,Utah Jazz,New York Knicks,108,94,14,1,0
504,2021-02-09T00:00:00.000Z,New Orleans Pelicans,Houston Rockets,130,101,29,1,0
505,2021-02-27T00:00:00.000Z,San Antonio Spurs,New Orleans Pelicans,117,114,3,1,0
506,2021-02-03T00:00:00.000Z,New Orleans Pelicans,Phoenix Suns,123,101,22,1,0
507,2021-02-05T00:00:00.000Z,Cleveland Cavaliers,Milwaukee Bucks,105,123,-18,0,1
508,2021-02-21T00:00:00.000Z,Orlando Magic,Detroit Pistons,105,96,9,1,0
509,2021-03-02T00:00:00.000Z,Los Angeles Lakers,Phoenix Suns,104,114,-10,0,1
510,2021-02-14T00:00:00.000Z,Oklahoma City Thunder,Milwaukee Bucks,114,109,5,1,0
511,2021-02-23T00:00:00.000Z,Milwaukee Bucks,Minnesota Timberwolves,139,112,27,1,0
512,2021-02-25T00:00:00.000Z,New York Knicks,Sacramento Kings,140,121,19,1,0
513,2021-02-15T00:00:00.000Z,Washington Wizards,Houston Rockets,131,119,12,1,0
514,2021-02-18T00:00:00.000Z,Milwaukee Bucks,Toronto Raptors,96,110,-14,0,1
515,2021-02-28T00:00:00.000Z,Minnesota Timberwolves,Phoenix Suns,99,118,-19,0,1
516,2021-03-03T00:00:00.000Z,Dallas Mavericks,Oklahoma City Thunder,87,78,9,1,0
517,2021-03-04T00:00:00.000Z,Memphis Grizzlies,Milwaukee Bucks,111,112,-1,0,1
518,2021-01-18T00:00:00.000Z,Atlanta Hawks,Minnesota Timberwolves,108,97,11,1,0
519,2021-01-31T00:00:00.000Z,Minnesota Timberwolves,Cleveland Cavaliers,109,104,5,1,0
520,2021-02-19T00:00:00.000Z,New Orleans Pelicans,Phoenix Suns,114,132,-18,0,1
521,2021-02-05T00:00:00.000Z,Phoenix Suns,Detroit Pistons,109,92,17,1,0
522,2021-02-24T00:00:00.000Z,Miami Heat,Toronto Raptors,116,108,8,1,0
523,2020-12-31T00:00:00.000Z,Washington Wizards,Chicago Bulls,130,133,-3,0,1
524,2020-12-30T00:00:00.000Z,Dallas Mavericks,Charlotte Hornets,99,118,-19,0,1
525,2021-01-04T00:00:00.000Z,Atlanta Hawks,New York Knicks,108,113,-5,0,1
526,2021-01-02T00:00:00.000Z,Atlanta Hawks,Cleveland Cavaliers,91,96,-5,0,1
527,2021-02-28T00:00:00.000Z,Detroit Pistons,New York Knicks,90,109,-19,0,1
528,2021-02-16T00:00:00.000Z,Memphis Grizzlies,New Orleans Pelicans,113,144,-31,0,1
529,2021-01-22T00:00:00.000Z,Toronto Raptors,Miami Heat,101,81,20,1,0
530,2021-02-02T00:00:00.000Z,Golden State Warriors,Boston Celtics,107,111,-4,0,1
531,2021-01-05T00:00:00.000Z,Denver Nuggets,Minnesota Timberwolves,123,116,7,1,0
532,2021-01-06T00:00:00.000Z,Philadelphia 76ers,Washington Wizards,141,136,5,1,0
533,2021-01-01T00:00:00.000Z,Brooklyn Nets,Atlanta Hawks,96,114,-18,0,1
534,2021-01-16T00:00:00.000Z,Miami Heat,Detroit Pistons,100,120,-20,0,1
535,2021-02-10T00:00:00.000Z,Chicago Bulls,New Orleans Pelicans,129,116,13,1,0
536,2021-01-30T00:00:00.000Z,Dallas Mavericks,Phoenix Suns,105,111,-6,0,1
537,2021-01-08T00:00:00.000Z,Los Angeles Lakers,Chicago Bulls,117,115,2,1,0
538,2021-01-03T00:00:00.000Z,Minnesota Timberwolves,Denver Nuggets,109,124,-15,0,1
539,2021-02-08T00:00:00.000Z,Memphis Grizzlies,Toronto Raptors,113,128,-15,0,1
540,2021-02-22T00:00:00.000Z,Dallas Mavericks,Memphis Grizzlies,102,92,10,1,0
541,2021-01-17T00:00:00.000Z,Oklahoma City Thunder,Philadelphia 76ers,93,117,-24,0,1
542,2021-02-12T00:00:00.000Z,Atlanta Hawks,San Antonio Spurs,114,125,-11,0,1
543,2021-01-09T00:00:00.000Z,Washington Wizards,Miami Heat,124,128,-4,0,1
544,2021-01-27T00:00:00.000Z,Philadelphia 76ers,Los Angeles Lakers,107,106,1,1,0
545,2021-02-25T00:00:00.000Z,Memphis Grizzlies,LA Clippers,122,94,28,1,0
546,2021-01-20T00:00:00.000Z,Minnesota Timberwolves,Orlando Magic,96,97,-1,0,1
547,2021-02-06T00:00:00.000Z,Atlanta Hawks,Toronto Raptors,132,121,11,1,0
548,2021-01-10T00:00:00.000Z,LA Clippers,Chicago Bulls,130,127,3,1,0
549,2021-01-11T00:00:00.000Z,Atlanta Hawks,Philadelphia 76ers,112,94,18,1,0
550,2021-02-01T00:00:00.000Z,Miami Heat,Charlotte Hornets,121,129,-8,0,1
551,2021-02-20T00:00:00.000Z,Los Angeles Lakers,Miami Heat,94,96,-2,0,1
552,2021-01-29T00:00:00.000Z,Minnesota Timberwolves,Philadelphia 76ers,94,118,-24,0,1
553,2021-03-01T00:00:00.000Z,Portland Trail Blazers,Charlotte Hornets,123,111,12,1,0
554,2021-01-25T00:00:00.000Z,Golden State Warriors,Minnesota Timberwolves,130,108,22,1,0
555,2021-02-14T00:00:00.000Z,Denver Nuggets,Los Angeles Lakers,122,105,17,1,0
556,2021-02-11T00:00:00.000Z,Golden State Warriors,Orlando Magic,111,105,6,1,0
557,2021-02-03T00:00:00.000Z,Milwaukee Bucks,Indiana Pacers,130,110,20,1,0
558,2021-02-09T00:00:00.000Z,Sacramento Kings,Philadelphia 76ers,111,119,-8,0,1
559,2021-02-07T00:00:00.000Z,LA Clippers,Sacramento Kings,110,113,-3,0,1
560,2021-02-26T00:00:00.000Z,Toronto Raptors,Houston Rockets,122,111,11,1,0
561,2021-02-23T00:00:00.000Z,Orlando Magic,Detroit Pistons,93,105,-12,0,1
562,2021-02-15T00:00:00.000Z,LA Clippers,Miami Heat,125,118,7,1,0
563,2021-02-17T00:00:00.000Z,Washington Wizards,Denver Nuggets,130,128,2,1,0
564,2021-02-21T00:00:00.000Z,Toronto Raptors,Philadelphia 76ers,110,103,7,1,0
565,2021-03-02T00:00:00.000Z,San Antonio Spurs,New York Knicks,119,93,26,1,0
566,2021-02-27T00:00:00.000Z,Washington Wizards,Minnesota Timberwolves,128,112,16,1,0
567,2021-03-03T00:00:00.000Z,Houston Rockets,Brooklyn Nets,114,132,-18,0,1
568,2021-01-15T00:00:00.000Z,Phoenix Suns,Golden State Warriors,120,98,22,1,0
569,2021-03-04T00:00:00.000Z,New Orleans Pelicans,Miami Heat,93,103,-10,0,1
570,2021-01-04T00:00:00.000Z,Houston Rockets,Dallas Mavericks,100,113,-13,0,1
571,2021-02-23T00:00:00.000Z,Dallas Mavericks,Boston Celtics,110,107,3,1,0
572,2021-01-13T00:00:00.000Z,Charlotte Hornets,Dallas Mavericks,93,104,-11,0,1
573,2021-01-15T00:00:00.000Z,Los Angeles Lakers,New Orleans Pelicans,112,95,17,1,0
574,2021-01-20T00:00:00.000Z,Indiana Pacers,Dallas Mavericks,112,124,-12,0,1
575,2021-02-19T00:00:00.000Z,LA Clippers,Utah Jazz,116,112,4,1,0
576,2021-01-29T00:00:00.000Z,Toronto Raptors,Sacramento Kings,124,126,-2,0,1
577,2021-02-26T00:00:00.000Z,Golden State Warriors,Charlotte Hornets,130,121,9,1,0
578,2021-02-21T00:00:00.000Z,Atlanta Hawks,Denver Nuggets,123,115,8,1,0
579,2021-01-24T00:00:00.000Z,Milwaukee Bucks,Atlanta Hawks,129,115,14,1,0
580,2021-02-14T00:00:00.000Z,LA Clippers,Cleveland Cavaliers,128,111,17,1,0
581,2021-02-06T00:00:00.000Z,Houston Rockets,San Antonio Spurs,106,111,-5,0,1
582,2021-01-09T00:00:00.000Z,Sacramento Kings,Portland Trail Blazers,99,125,-26,0,1
583,2021-02-01T00:00:00.000Z,San Antonio Spurs,Memphis Grizzlies,102,133,-31,0,1
584,2021-01-08T00:00:00.000Z,New York Knicks,Oklahoma City Thunder,89,101,-12,0,1
585,2021-01-18T00:00:00.000Z,Chicago Bulls,Houston Rockets,125,120,5,1,0
586,2020-12-31T00:00:00.000Z,Utah Jazz,Phoenix Suns,95,106,-11,0,1
587,2021-01-10T00:00:00.000Z,Houston Rockets,Los Angeles Lakers,102,120,-18,0,1
588,2021-01-11T00:00:00.000Z,Portland Trail Blazers,Toronto Raptors,112,111,1,1,0
589,2021-01-07T00:00:00.000Z,Los Angeles Lakers,San Antonio Spurs,109,118,-9,0,1
590,2021-01-06T00:00:00.000Z,New Orleans Pelicans,Oklahoma City Thunder,110,111,-1,0,1
591,2021-01-01T00:00:00.000Z,Minnesota Timberwolves,Washington Wizards,109,130,-21,0,1
592,2021-02-03T00:00:00.000Z,Atlanta Hawks,Dallas Mavericks,116,122,-6,0,1
593,2021-01-03T00:00:00.000Z,Golden State Warriors,Portland Trail Blazers,137,122,15,1,0
594,2021-01-22T00:00:00.000Z,Portland Trail Blazers,Memphis Grizzlies,113,120,-7,0,1
595,2021-02-28T00:00:00.000Z,Los Angeles Lakers,Golden State Warriors,117,91,26,1,0
596,2021-02-05T00:00:00.000Z,Miami Heat,Washington Wizards,122,95,27,1,0
597,2021-02-22T00:00:00.000Z,Los Angeles Lakers,Washington Wizards,124,127,-3,0,1
598,2021-01-27T00:00:00.000Z,San Antonio Spurs,Boston Celtics,110,106,4,1,0
599,2021-01-25T00:00:00.000Z,Memphis Grizzlies,Sacramento Kings,107,106,1,1,0
600,2021-01-23T00:00:00.000Z,Detroit Pistons,Philadelphia 76ers,110,114,-4,0,1
601,2021-02-24T00:00:00.000Z,Oklahoma City Thunder,San Antonio Spurs,102,99,3,1,0
602,2021-02-17T00:00:00.000Z,New Orleans Pelicans,Portland Trail Blazers,124,126,-2,0,1
603,2021-02-02T00:00:00.000Z,Indiana Pacers,Memphis Grizzlies,134,116,18,1,0
604,2021-02-12T00:00:00.000Z,Portland Trail Blazers,Cleveland Cavaliers,129,110,19,1,0
605,2021-01-22T00:00:00.000Z,Milwaukee Bucks,Washington Wizards,135,134,1,1,0
606,2021-03-03T00:00:00.000Z,Portland Trail Blazers,Golden State Warriors,108,106,2,1,0
607,2021-02-20T00:00:00.000Z,New York Knicks,San Antonio Spurs,102,98,4,1,0
608,2021-01-20T00:00:00.000Z,Cleveland Cavaliers,Brooklyn Nets,147,135,12,1,0
609,2021-01-08T00:00:00.000Z,Memphis Grizzlies,Brooklyn Nets,115,110,5,1,0
610,2021-01-25T00:00:00.000Z,New Orleans Pelicans,San Antonio Spurs,108,110,-2,0,1
611,2021-02-19T00:00:00.000Z,Orlando Magic,Golden State Warriors,124,120,4,1,0
612,2021-01-29T00:00:00.000Z,Utah Jazz,Dallas Mavericks,120,101,19,1,0
613,2021-01-10T00:00:00.000Z,Golden State Warriors,Toronto Raptors,106,105,1,1,0
614,2021-01-11T00:00:00.000Z,Sacramento Kings,Indiana Pacers,127,122,5,1,0
615,2021-01-15T00:00:00.000Z,Sacramento Kings,LA Clippers,100,138,-38,0,1
616,2021-02-07T00:00:00.000Z,Charlotte Hornets,Portland Trail Blazers,109,101,8,1,0
617,2021-01-25T00:00:00.000Z,Portland Trail Blazers,Oklahoma City Thunder,122,125,-3,0,1
618,2021-01-26T00:00:00.000Z,Atlanta Hawks,LA Clippers,108,99,9,1,0
619,2021-01-06T00:00:00.000Z,Golden State Warriors,LA Clippers,101,108,-7,0,1
620,2021-02-12T00:00:00.000Z,Los Angeles Lakers,Memphis Grizzlies,115,105,10,1,0
621,2021-02-10T00:00:00.000Z,Phoenix Suns,Milwaukee Bucks,125,124,1,1,0
622,2021-02-08T00:00:00.000Z,San Antonio Spurs,Golden State Warriors,105,100,5,1,0
623,2021-01-16T00:00:00.000Z,San Antonio Spurs,Houston Rockets,103,91,12,1,0
624,2021-01-09T00:00:00.000Z,Milwaukee Bucks,Cleveland Cavaliers,100,90,10,1,0
625,2021-01-17T00:00:00.000Z,LA Clippers,Indiana Pacers,129,96,33,1,0
626,2021-01-18T00:00:00.000Z,Brooklyn Nets,Milwaukee Bucks,125,123,2,1,0
627,2021-01-19T00:00:00.000Z,Denver Nuggets,Oklahoma City Thunder,119,101,18,1,0
628,2021-01-01T00:00:00.000Z,Golden State Warriors,Portland Trail Blazers,98,123,-25,0,1
629,2021-01-30T00:00:00.000Z,Charlotte Hornets,Milwaukee Bucks,126,114,12,1,0
630,2021-02-05T00:00:00.000Z,LA Clippers,Boston Celtics,115,119,-4,0,1
631,2021-02-01T00:00:00.000Z,Dallas Mavericks,Phoenix Suns,108,109,-1,0,1
632,2021-01-22T00:00:00.000Z,Phoenix Suns,Denver Nuggets,126,130,-4,0,1
633,2021-01-23T00:00:00.000Z,Minnesota Timberwolves,New Orleans Pelicans,120,110,10,1,0
634,2021-02-03T00:00:00.000Z,Sacramento Kings,Boston Celtics,116,111,5,1,0
635,2021-01-27T00:00:00.000Z,Orlando Magic,Sacramento Kings,107,121,-14,0,1
636,2021-02-18T00:00:00.000Z,Sacramento Kings,Miami Heat,110,118,-8,0,1
637,2021-02-17T00:00:00.000Z,Golden State Warriors,Miami Heat,120,112,8,1,0
638,2021-02-06T00:00:00.000Z,New York Knicks,Portland Trail Blazers,110,99,11,1,0
639,2021-02-06T00:00:00.000Z,Los Angeles Lakers,Detroit Pistons,135,129,6,1,0
640,2021-01-24T00:00:00.000Z,Memphis Grizzlies,Sacramento Kings,116,110,6,1,0
641,2021-02-28T00:00:00.000Z,Houston Rockets,Memphis Grizzlies,84,133,-49,0,1
642,2021-02-08T00:00:00.000Z,Los Angeles Lakers,Oklahoma City Thunder,119,112,7,1,0
643,2021-01-30T00:00:00.000Z,San Antonio Spurs,Memphis Grizzlies,112,129,-17,0,1
644,2021-02-23T00:00:00.000Z,LA Clippers,Washington Wizards,135,116,19,1,0
645,2021-01-03T00:00:00.000Z,San Antonio Spurs,Utah Jazz,109,130,-21,0,1
646,2021-02-15T00:00:00.000Z,Utah Jazz,Philadelphia 76ers,134,123,11,1,0
647,2021-01-05T00:00:00.000Z,Portland Trail Blazers,Chicago Bulls,108,111,-3,0,1
648,2021-02-14T00:00:00.000Z,Sacramento Kings,Memphis Grizzlies,110,124,-14,0,1
649,2021-02-04T00:00:00.000Z,Dallas Mavericks,Golden State Warriors,116,147,-31,0,1
650,2021-03-01T00:00:00.000Z,San Antonio Spurs,Brooklyn Nets,113,124,-11,0,1
651,2021-01-20T00:00:00.000Z,Golden State Warriors,San Antonio Spurs,121,99,22,1,0
652,2021-01-02T00:00:00.000Z,Indiana Pacers,New York Knicks,102,106,-4,0,1
653,2021-01-01T00:00:00.000Z,Utah Jazz,LA Clippers,106,100,6,1,0
654,2021-01-31T00:00:00.000Z,Washington Wizards,Brooklyn Nets,149,146,3,1,0
655,2021-02-09T00:00:00.000Z,San Antonio Spurs,Golden State Warriors,91,114,-23,0,1
656,2021-01-06T00:00:00.000Z,Atlanta Hawks,Charlotte Hornets,94,102,-8,0,1
657,2021-01-24T00:00:00.000Z,Portland Trail Blazers,New York Knicks,116,113,3,1,0
658,2021-02-10T00:00:00.000Z,Minnesota Timberwolves,LA Clippers,112,119,-7,0,1
659,2021-02-01T00:00:00.000Z,Milwaukee Bucks,Portland Trail Blazers,134,106,28,1,0
660,2021-01-28T00:00:00.000Z,Miami Heat,LA Clippers,105,109,-4,0,1
661,2021-02-05T00:00:00.000Z,Brooklyn Nets,Toronto Raptors,117,123,-6,0,1
662,2021-01-04T00:00:00.000Z,Milwaukee Bucks,Detroit Pistons,125,115,10,1,0
663,2021-01-25T00:00:00.000Z,Orlando Magic,Charlotte Hornets,117,108,9,1,0
664,2021-01-16T00:00:00.000Z,Portland Trail Blazers,Atlanta Hawks,112,106,6,1,0
665,2021-02-24T00:00:00.000Z,Cleveland Cavaliers,Houston Rockets,112,96,16,1,0
666,2021-01-15T00:00:00.000Z,Utah Jazz,Atlanta Hawks,116,92,24,1,0
667,2021-02-06T00:00:00.000Z,New Orleans Pelicans,Memphis Grizzlies,118,109,9,1,0
668,2021-01-27T00:00:00.000Z,Toronto Raptors,Milwaukee Bucks,108,115,-7,0,1
669,2021-01-27T00:00:00.000Z,Golden State Warriors,Minnesota Timberwolves,123,111,12,1,0
670,2021-01-08T00:00:00.000Z,Sacramento Kings,Toronto Raptors,123,144,-21,0,1
671,2021-02-17T00:00:00.000Z,Orlando Magic,New York Knicks,107,89,18,1,0
672,2021-02-16T00:00:00.000Z,Minnesota Timberwolves,Los Angeles Lakers,104,112,-8,0,1
673,2021-01-22T00:00:00.000Z,Minnesota Timberwolves,Atlanta Hawks,98,116,-18,0,1
674,2021-01-29T00:00:00.000Z,Orlando Magic,LA Clippers,90,116,-26,0,1
675,2021-02-25T00:00:00.000Z,Milwaukee Bucks,New Orleans Pelicans,129,125,4,1,0
676,2021-01-17T00:00:00.000Z,Dallas Mavericks,Chicago Bulls,101,117,-16,0,1
677,2021-02-12T00:00:00.000Z,Dallas Mavericks,New Orleans Pelicans,143,130,13,1,0
678,2021-01-18T00:00:00.000Z,Portland Trail Blazers,San Antonio Spurs,104,125,-21,0,1
679,2021-02-19T00:00:00.000Z,Milwaukee Bucks,Oklahoma City Thunder,98,85,13,1,0
680,2021-02-26T00:00:00.000Z,Boston Celtics,Indiana Pacers,118,112,6,1,0
681,2021-02-03T00:00:00.000Z,Chicago Bulls,New York Knicks,103,107,-4,0,1
682,2021-02-27T00:00:00.000Z,Orlando Magic,Utah Jazz,109,124,-15,0,1
683,2021-03-02T00:00:00.000Z,Toronto Raptors,Detroit Pistons,105,129,-24,0,1
684,2021-03-03T00:00:00.000Z,New Orleans Pelicans,Chicago Bulls,124,128,-4,0,1
685,2021-03-04T00:00:00.000Z,Portland Trail Blazers,Sacramento Kings,123,119,4,1,0
686,2021-01-12T00:00:00.000Z,Oklahoma City Thunder,San Antonio Spurs,102,112,-10,0,1
687,2021-01-14T00:00:00.000Z,Portland Trail Blazers,Indiana Pacers,87,111,-24,0,1
688,2021-02-14T00:00:00.000Z,Detroit Pistons,New Orleans Pelicans,123,112,11,1,0
689,2021-05-18T00:00:00.000Z,Boston Celtics,Washington Wizards,118,100,18,1,0
690,2021-01-12T00:00:00.000Z,Cleveland Cavaliers,Utah Jazz,87,117,-30,0,1
691,2021-02-14T00:00:00.000Z,Washington Wizards,Boston Celtics,104,91,13,1,0
692,2021-05-18T00:00:00.000Z,Indiana Pacers,Charlotte Hornets,144,117,27,1,0
693,2021-02-17T00:00:00.000Z,Chicago Bulls,Detroit Pistons,105,102,3,1,0
694,2021-01-12T00:00:00.000Z,Chicago Bulls,Boston Celtics,121,99,22,1,0
695,2021-05-19T00:00:00.000Z,Los Angeles Lakers,Golden State Warriors,103,100,3,1,0
696,2021-01-12T00:00:00.000Z,Brooklyn Nets,Denver Nuggets,122,116,6,1,0
697,2021-02-17T00:00:00.000Z,Memphis Grizzlies,Oklahoma City Thunder,122,113,9,1,0
698,2021-05-19T00:00:00.000Z,Memphis Grizzlies,San Antonio Spurs,100,96,4,1,0
699,2021-01-12T00:00:00.000Z,Golden State Warriors,Indiana Pacers,95,104,-9,0,1
700,2021-02-19T00:00:00.000Z,Cleveland Cavaliers,Denver Nuggets,103,120,-17,0,1
701,2021-01-13T00:00:00.000Z,Washington Wizards,Utah Jazz,131,122,9,1,0
702,2021-05-20T00:00:00.000Z,Washington Wizards,Indiana Pacers,142,115,27,1,0
703,2021-01-12T00:00:00.000Z,Philadelphia 76ers,Miami Heat,137,134,3,1,0
704,2021-03-04T00:00:00.000Z,New York Knicks,Detroit Pistons,114,104,10,1,0
705,2021-05-21T00:00:00.000Z,Golden State Warriors,Memphis Grizzlies,112,117,-5,0,1
706,2021-01-13T00:00:00.000Z,Boston Celtics,Orlando Magic,112,96,16,1,0
707,2021-01-13T00:00:00.000Z,Phoenix Suns,Atlanta Hawks,117,110,7,1,0
708,2021-01-12T00:00:00.000Z,Houston Rockets,Los Angeles Lakers,100,117,-17,0,1
709,2021-01-14T00:00:00.000Z,Denver Nuggets,Golden State Warriors,114,104,10,1,0
710,2021-05-22T00:00:00.000Z,LA Clippers,Dallas Mavericks,103,113,-10,0,1
711,2021-05-22T00:00:00.000Z,Milwaukee Bucks,Miami Heat,109,107,2,1,0
712,2021-05-22T00:00:00.000Z,Denver Nuggets,Portland Trail Blazers,109,123,-14,0,1
713,2021-05-22T00:00:00.000Z,Brooklyn Nets,Boston Celtics,104,93,11,1,0
714,2021-01-14T00:00:00.000Z,Toronto Raptors,Charlotte Hornets,111,108,3,1,0
715,2021-05-23T00:00:00.000Z,Philadelphia 76ers,Washington Wizards,125,118,7,1,0
716,2021-01-14T00:00:00.000Z,Philadelphia 76ers,Miami Heat,125,108,17,1,0
717,2021-05-23T00:00:00.000Z,Utah Jazz,Memphis Grizzlies,109,112,-3,0,1
718,2021-01-14T00:00:00.000Z,San Antonio Spurs,Houston Rockets,105,109,-4,0,1
719,2021-05-23T00:00:00.000Z,Phoenix Suns,Los Angeles Lakers,99,90,9,1,0
720,2021-02-02T00:00:00.000Z,Washington Wizards,Portland Trail Blazers,121,132,-11,0,1
721,2021-05-23T00:00:00.000Z,New York Knicks,Atlanta Hawks,105,107,-2,0,1
722,2021-05-24T00:00:00.000Z,Denver Nuggets,Portland Trail Blazers,128,109,19,1,0
723,2021-05-24T00:00:00.000Z,Milwaukee Bucks,Miami Heat,132,98,34,1,0
724,2021-05-25T00:00:00.000Z,Brooklyn Nets,Boston Celtics,130,108,22,1,0
725,2021-05-25T00:00:00.000Z,LA Clippers,Dallas Mavericks,121,127,-6,0,1
726,2021-05-25T00:00:00.000Z,Phoenix Suns,Los Angeles Lakers,102,109,-7,0,1
727,2021-05-26T00:00:00.000Z,New York Knicks,Atlanta Hawks,101,92,9,1,0
728,2021-05-26T00:00:00.000Z,Utah Jazz,Memphis Grizzlies,141,129,12,1,0
729,2021-05-26T00:00:00.000Z,Philadelphia 76ers,Washington Wizards,120,95,25,1,0
730,2021-05-27T00:00:00.000Z,Portland Trail Blazers,Denver Nuggets,115,120,-5,0,1
731,2021-05-27T00:00:00.000Z,Los Angeles Lakers,Phoenix Suns,109,95,14,1,0
732,2021-05-27T00:00:00.000Z,Miami Heat,Milwaukee Bucks,84,113,-29,0,1
733,2021-05-28T00:00:00.000Z,Atlanta Hawks,New York Knicks,105,94,11,1,0
734,2021-05-28T00:00:00.000Z,Boston Celtics,Brooklyn Nets,125,119,6,1,0
735,2021-05-28T00:00:00.000Z,Dallas Mavericks,LA Clippers,108,118,-10,0,1
736,2021-01-13T00:00:00.000Z,LA Clippers,New Orleans Pelicans,111,106,5,1,0
737,2021-05-29T00:00:00.000Z,Portland Trail Blazers,Denver Nuggets,0,0,0,0,0
738,2021-05-29T00:00:00.000Z,Memphis Grizzlies,Utah Jazz,0,0,0,0,0
739,2021-05-29T00:00:00.000Z,Washington Wizards,Philadelphia 76ers,0,0,0,0,0
740,2021-05-29T00:00:00.000Z,Miami Heat,Milwaukee Bucks,103,120,-17,0,1
741,2021-01-13T00:00:00.000Z,New York Knicks,Brooklyn Nets,109,116,-7,0,1
742,2021-01-13T00:00:00.000Z,Sacramento Kings,Portland Trail Blazers,126,132,-6,0,1
743,2021-01-13T00:00:00.000Z,Minnesota Timberwolves,Memphis Grizzlies,107,118,-11,0,1
744,2021-01-13T00:00:00.000Z,Oklahoma City Thunder,Los Angeles Lakers,99,128,-29,0,1
745,2021-05-12T00:00:00.000Z,Los Angeles Lakers,Houston Rockets,124,122,2,1,0
746,2021-03-26T00:00:00.000Z,Charlotte Hornets,Miami Heat,110,105,5,1,0
747,2021-04-12T00:00:00.000Z,Utah Jazz,Washington Wizards,121,125,-4,0,1
748,2021-03-17T00:00:00.000Z,Houston Rockets,Golden State Warriors,94,108,-14,0,1
749,2021-04-09T00:00:00.000Z,New Orleans Pelicans,Philadelphia 76ers,101,94,7,1,0
750,2021-04-05T00:00:00.000Z,Oklahoma City Thunder,Detroit Pistons,108,132,-24,0,1
751,2021-05-05T00:00:00.000Z,Utah Jazz,San Antonio Spurs,126,94,32,1,0
752,2021-03-25T00:00:00.000Z,San Antonio Spurs,LA Clippers,85,98,-13,0,1
753,2021-05-07T00:00:00.000Z,Utah Jazz,Denver Nuggets,127,120,7,1,0
754,2021-04-02T00:00:00.000Z,Portland Trail Blazers,Milwaukee Bucks,109,127,-18,0,1
755,2021-04-30T00:00:00.000Z,Phoenix Suns,Utah Jazz,121,100,21,1,0
756,2021-04-18T00:00:00.000Z,Toronto Raptors,Oklahoma City Thunder,112,106,6,1,0
757,2021-03-16T00:00:00.000Z,Houston Rockets,Atlanta Hawks,107,119,-12,0,1
758,2021-04-24T00:00:00.000Z,Utah Jazz,Minnesota Timberwolves,96,101,-5,0,1
759,2021-03-24T00:00:00.000Z,Utah Jazz,Brooklyn Nets,118,88,30,1,0
760,2021-03-15T00:00:00.000Z,Golden State Warriors,Los Angeles Lakers,97,128,-31,0,1
761,2021-03-21T00:00:00.000Z,Houston Rockets,Oklahoma City Thunder,112,114,-2,0,1
762,2021-04-27T00:00:00.000Z,Boston Celtics,Oklahoma City Thunder,115,119,-4,0,1
763,2021-03-14T00:00:00.000Z,Golden State Warriors,Utah Jazz,131,119,12,1,0
764,2021-03-13T00:00:00.000Z,Charlotte Hornets,Toronto Raptors,114,104,10,1,0
765,2021-04-11T00:00:00.000Z,Dallas Mavericks,San Antonio Spurs,117,119,-2,0,1
766,2021-03-31T00:00:00.000Z,San Antonio Spurs,Sacramento Kings,120,106,14,1,0
767,2021-03-10T00:00:00.000Z,Memphis Grizzlies,Washington Wizards,127,112,15,1,0
768,2021-03-12T00:00:00.000Z,San Antonio Spurs,Orlando Magic,104,77,27,1,0
769,2021-03-11T00:00:00.000Z,Brooklyn Nets,Boston Celtics,121,109,12,1,0
770,2021-03-11T00:00:00.000Z,Chicago Bulls,Philadelphia 76ers,105,127,-22,0,1
771,2021-03-11T00:00:00.000Z,Toronto Raptors,Atlanta Hawks,120,121,-1,0,1
772,2021-03-11T00:00:00.000Z,New Orleans Pelicans,Minnesota Timberwolves,105,135,-30,0,1
773,2021-04-08T00:00:00.000Z,LA Clippers,Phoenix Suns,113,103,10,1,0
774,2021-04-04T00:00:00.000Z,Philadelphia 76ers,Memphis Grizzlies,100,116,-16,0,1
775,2021-03-20T00:00:00.000Z,Los Angeles Lakers,Atlanta Hawks,94,99,-5,0,1
776,2021-03-29T00:00:00.000Z,San Antonio Spurs,Sacramento Kings,115,132,-17,0,1
777,2021-04-21T00:00:00.000Z,San Antonio Spurs,Miami Heat,87,107,-20,0,1
778,2021-04-17T00:00:00.000Z,Los Angeles Lakers,Utah Jazz,127,115,12,1,0
779,2021-05-16T00:00:00.000Z,New York Knicks,Boston Celtics,96,92,4,1,0
780,2021-03-19T00:00:00.000Z,Phoenix Suns,Minnesota Timberwolves,113,101,12,1,0
781,2021-03-27T00:00:00.000Z,LA Clippers,Philadelphia 76ers,122,112,10,1,0
782,2021-05-11T00:00:00.000Z,Sacramento Kings,Oklahoma City Thunder,122,106,16,1,0
783,2021-04-23T00:00:00.000Z,Oklahoma City Thunder,Washington Wizards,109,129,-20,0,1
784,2021-04-10T00:00:00.000Z,Phoenix Suns,Washington Wizards,134,106,28,1,0
785,2021-04-06T00:00:00.000Z,Golden State Warriors,Milwaukee Bucks,122,121,1,1,0
786,2021-04-03T00:00:00.000Z,Detroit Pistons,New York Knicks,81,125,-44,0,1
787,2021-04-15T00:00:00.000Z,Los Angeles Lakers,Boston Celtics,113,121,-8,0,1
788,2021-05-06T00:00:00.000Z,Toronto Raptors,Washington Wizards,129,131,-2,0,1
789,2021-04-25T00:00:00.000Z,Golden State Warriors,Sacramento Kings,117,113,4,1,0
790,2021-04-19T00:00:00.000Z,Denver Nuggets,Memphis Grizzlies,139,137,2,1,0
791,2021-04-26T00:00:00.000Z,New York Knicks,Phoenix Suns,110,118,-8,0,1
792,2021-04-26T00:00:00.000Z,Sacramento Kings,Dallas Mavericks,113,106,7,1,0
793,2021-04-16T00:00:00.000Z,Utah Jazz,Indiana Pacers,119,111,8,1,0
794,2021-04-16T00:00:00.000Z,Dallas Mavericks,New York Knicks,109,117,-8,0,1
795,2021-05-01T00:00:00.000Z,Oklahoma City Thunder,Indiana Pacers,95,152,-57,0,1
796,2021-04-28T00:00:00.000Z,Miami Heat,San Antonio Spurs,116,111,5,1,0
797,2021-04-22T00:00:00.000Z,San Antonio Spurs,Detroit Pistons,106,91,15,1,0
798,2021-03-10T00:00:00.000Z,Dallas Mavericks,San Antonio Spurs,115,104,11,1,0
799,2021-04-03T00:00:00.000Z,Utah Jazz,Orlando Magic,137,91,46,1,0
800,2021-03-31T00:00:00.000Z,Boston Celtics,Dallas Mavericks,108,113,-5,0,1
801,2021-03-29T00:00:00.000Z,Oklahoma City Thunder,Dallas Mavericks,106,127,-21,0,1
802,2021-03-17T00:00:00.000Z,Chicago Bulls,San Antonio Spurs,99,106,-7,0,1
803,2021-03-15T00:00:00.000Z,Phoenix Suns,Memphis Grizzlies,122,99,23,1,0
804,2021-03-22T00:00:00.000Z,Cleveland Cavaliers,Sacramento Kings,105,119,-14,0,1
805,2021-04-05T00:00:00.000Z,Toronto Raptors,Washington Wizards,103,101,2,1,0
806,2021-03-13T00:00:00.000Z,Washington Wizards,Milwaukee Bucks,119,125,-6,0,1
807,2021-03-24T00:00:00.000Z,Milwaukee Bucks,Boston Celtics,121,119,2,1,0
808,2021-03-12T00:00:00.000Z,Memphis Grizzlies,Denver Nuggets,102,103,-1,0,1
809,2021-03-11T00:00:00.000Z,Charlotte Hornets,Detroit Pistons,105,102,3,1,0
810,2021-03-11T00:00:00.000Z,Miami Heat,Orlando Magic,111,103,8,1,0
811,2021-03-11T00:00:00.000Z,Milwaukee Bucks,New York Knicks,134,101,33,1,0
812,2021-03-11T00:00:00.000Z,Sacramento Kings,Houston Rockets,125,105,20,1,0
813,2021-03-14T00:00:00.000Z,Atlanta Hawks,Cleveland Cavaliers,100,82,18,1,0
814,2021-04-07T00:00:00.000Z,Brooklyn Nets,New Orleans Pelicans,139,111,28,1,0
815,2021-05-07T00:00:00.000Z,Milwaukee Bucks,Houston Rockets,141,133,8,1,0
816,2021-04-09T00:00:00.000Z,Cleveland Cavaliers,Toronto Raptors,115,135,-20,0,1
817,2021-03-21T00:00:00.000Z,Phoenix Suns,Los Angeles Lakers,111,94,17,1,0
818,2021-04-02T00:00:00.000Z,Phoenix Suns,Oklahoma City Thunder,140,103,37,1,0
819,2021-04-10T00:00:00.000Z,Portland Trail Blazers,Detroit Pistons,118,103,15,1,0
820,2021-05-06T00:00:00.000Z,Golden State Warriors,Oklahoma City Thunder,118,97,21,1,0
821,2021-04-08T00:00:00.000Z,Dallas Mavericks,Milwaukee Bucks,116,101,15,1,0
822,2021-05-03T00:00:00.000Z,Utah Jazz,San Antonio Spurs,110,99,11,1,0
823,2021-04-30T00:00:00.000Z,Memphis Grizzlies,Orlando Magic,92,75,17,1,0
824,2021-04-12T00:00:00.000Z,Golden State Warriors,Denver Nuggets,116,107,9,1,0
825,2021-03-26T00:00:00.000Z,Utah Jazz,Memphis Grizzlies,117,114,3,1,0
826,2021-05-13T00:00:00.000Z,Miami Heat,Philadelphia 76ers,106,94,12,1,0
827,2021-04-28T00:00:00.000Z,Denver Nuggets,New Orleans Pelicans,114,112,2,1,0
828,2021-05-14T00:00:00.000Z,Houston Rockets,LA Clippers,122,115,7,1,0
829,2021-04-04T00:00:00.000Z,Denver Nuggets,Orlando Magic,119,109,10,1,0
830,2021-04-06T00:00:00.000Z,Miami Heat,Memphis Grizzlies,112,124,-12,0,1
831,2021-03-16T00:00:00.000Z,Boston Celtics,Utah Jazz,109,117,-8,0,1
832,2021-04-25T00:00:00.000Z,Atlanta Hawks,Milwaukee Bucks,111,104,7,1,0
833,2021-04-23T00:00:00.000Z,Houston Rockets,LA Clippers,104,109,-5,0,1
834,2021-03-19T00:00:00.000Z,Denver Nuggets,Chicago Bulls,131,127,4,1,0
835,2021-03-30T00:00:00.000Z,LA Clippers,Orlando Magic,96,103,-7,0,1
836,2021-03-27T00:00:00.000Z,New Orleans Pelicans,Dallas Mavericks,112,103,9,1,0
837,2021-04-21T00:00:00.000Z,LA Clippers,Memphis Grizzlies,117,105,12,1,0
838,2021-03-23T00:00:00.000Z,Portland Trail Blazers,Brooklyn Nets,112,116,-4,0,1
839,2021-04-16T00:00:00.000Z,Minnesota Timberwolves,Miami Heat,119,111,8,1,0
840,2021-04-26T00:00:00.000Z,Toronto Raptors,Cleveland Cavaliers,112,96,16,1,0
841,2021-04-11T00:00:00.000Z,New York Knicks,Toronto Raptors,102,96,6,1,0
842,2021-05-01T00:00:00.000Z,Atlanta Hawks,Chicago Bulls,108,97,11,1,0
843,2021-05-04T00:00:00.000Z,New Orleans Pelicans,Golden State Warriors,108,103,5,1,0
844,2021-04-13T00:00:00.000Z,Portland Trail Blazers,Boston Celtics,115,116,-1,0,1
845,2021-04-14T00:00:00.000Z,Toronto Raptors,San Antonio Spurs,117,112,5,1,0
846,2021-04-29T00:00:00.000Z,Oklahoma City Thunder,New Orleans Pelicans,95,109,-14,0,1
847,2021-04-24T00:00:00.000Z,Miami Heat,Chicago Bulls,106,101,5,1,0
848,2021-04-22T00:00:00.000Z,Milwaukee Bucks,Philadelphia 76ers,124,117,7,1,0
849,2021-05-11T00:00:00.000Z,Golden State Warriors,Phoenix Suns,122,116,6,1,0
850,2021-05-02T00:00:00.000Z,Los Angeles Lakers,Toronto Raptors,114,121,-7,0,1
851,2021-05-05T00:00:00.000Z,Atlanta Hawks,Phoenix Suns,135,103,32,1,0
852,2021-05-16T00:00:00.000Z,San Antonio Spurs,Phoenix Suns,121,123,-2,0,1
853,2021-05-16T00:00:00.000Z,New Orleans Pelicans,Los Angeles Lakers,98,110,-12,0,1
854,2021-05-12T00:00:00.000Z,Dallas Mavericks,New Orleans Pelicans,125,107,18,1,0
855,2021-04-03T00:00:00.000Z,Portland Trail Blazers,Oklahoma City Thunder,133,85,48,1,0
856,2021-04-11T00:00:00.000Z,LA Clippers,Detroit Pistons,131,124,7,1,0
857,2021-03-20T00:00:00.000Z,Philadelphia 76ers,Sacramento Kings,129,105,24,1,0
858,2021-04-06T00:00:00.000Z,LA Clippers,Portland Trail Blazers,133,116,17,1,0
859,2021-03-14T00:00:00.000Z,Minnesota Timberwolves,Portland Trail Blazers,114,112,2,1,0
860,2021-03-17T00:00:00.000Z,Memphis Grizzlies,Miami Heat,89,85,4,1,0
861,2021-04-01T00:00:00.000Z,Cleveland Cavaliers,Philadelphia 76ers,94,114,-20,0,1
862,2021-05-16T00:00:00.000Z,Oklahoma City Thunder,LA Clippers,117,112,5,1,0
863,2021-03-23T00:00:00.000Z,Orlando Magic,Denver Nuggets,99,110,-11,0,1
864,2021-03-19T00:00:00.000Z,Portland Trail Blazers,Dallas Mavericks,125,119,6,1,0
865,2021-03-11T00:00:00.000Z,LA Clippers,Golden State Warriors,130,104,26,1,0
866,2021-04-15T00:00:00.000Z,Cleveland Cavaliers,Golden State Warriors,101,119,-18,0,1
867,2021-03-15T00:00:00.000Z,Brooklyn Nets,New York Knicks,117,112,5,1,0
868,2021-04-08T00:00:00.000Z,Sacramento Kings,Detroit Pistons,101,113,-12,0,1
869,2021-03-29T00:00:00.000Z,Utah Jazz,Cleveland Cavaliers,114,75,39,1,0
870,2021-04-25T00:00:00.000Z,Orlando Magic,Indiana Pacers,112,131,-19,0,1
871,2021-03-26T00:00:00.000Z,Minnesota Timberwolves,Houston Rockets,107,101,6,1,0
872,2021-03-26T00:00:00.000Z,Los Angeles Lakers,Cleveland Cavaliers,100,86,14,1,0
873,2021-03-24T00:00:00.000Z,Chicago Bulls,Cleveland Cavaliers,94,103,-9,0,1
874,2021-03-22T00:00:00.000Z,LA Clippers,Atlanta Hawks,119,110,9,1,0
875,2021-05-07T00:00:00.000Z,Portland Trail Blazers,Los Angeles Lakers,106,101,5,1,0
876,2021-03-12T00:00:00.000Z,Chicago Bulls,Miami Heat,90,101,-11,0,1
877,2021-05-11T00:00:00.000Z,Milwaukee Bucks,Orlando Magic,114,102,12,1,0
878,2021-04-18T00:00:00.000Z,Dallas Mavericks,Sacramento Kings,107,121,-14,0,1
879,2021-04-09T00:00:00.000Z,Orlando Magic,Indiana Pacers,106,111,-5,0,1
880,2021-03-31T00:00:00.000Z,Brooklyn Nets,Houston Rockets,120,108,12,1,0
881,2021-04-16T00:00:00.000Z,Detroit Pistons,Oklahoma City Thunder,110,104,6,1,0
882,2021-05-01T00:00:00.000Z,LA Clippers,Denver Nuggets,104,110,-6,0,1
883,2021-04-27T00:00:00.000Z,Houston Rockets,Minnesota Timberwolves,107,114,-7,0,1
884,2021-03-21T00:00:00.000Z,Brooklyn Nets,Washington Wizards,113,106,7,1,0
885,2021-03-27T00:00:00.000Z,Washington Wizards,Detroit Pistons,106,92,14,1,0
886,2021-05-05T00:00:00.000Z,Denver Nuggets,New York Knicks,113,97,16,1,0
887,2021-04-07T00:00:00.000Z,Oklahoma City Thunder,Charlotte Hornets,102,113,-11,0,1
888,2021-04-19T00:00:00.000Z,Miami Heat,Houston Rockets,113,91,22,1,0
889,2021-04-14T00:00:00.000Z,Denver Nuggets,Miami Heat,123,106,17,1,0
890,2021-04-02T00:00:00.000Z,Utah Jazz,Chicago Bulls,113,106,7,1,0
891,2021-04-14T00:00:00.000Z,Memphis Grizzlies,Dallas Mavericks,113,114,-1,0,1
892,2021-04-21T00:00:00.000Z,Sacramento Kings,Minnesota Timberwolves,128,125,3,1,0
893,2021-04-28T00:00:00.000Z,Washington Wizards,Los Angeles Lakers,116,107,9,1,0
894,2021-04-24T00:00:00.000Z,Dallas Mavericks,Los Angeles Lakers,108,93,15,1,0
895,2021-04-22T00:00:00.000Z,Boston Celtics,Phoenix Suns,99,86,13,1,0
896,2021-04-26T00:00:00.000Z,Miami Heat,Chicago Bulls,102,110,-8,0,1
897,2021-05-02T00:00:00.000Z,Milwaukee Bucks,Brooklyn Nets,68,114,-46,0,1
898,2021-05-08T00:00:00.000Z,Indiana Pacers,Washington Wizards,132,133,-1,0,1
899,2021-05-13T00:00:00.000Z,Chicago Bulls,Toronto Raptors,114,102,12,1,0
900,2021-05-03T00:00:00.000Z,Los Angeles Lakers,Denver Nuggets,93,89,4,1,0
901,2021-05-09T00:00:00.000Z,Orlando Magic,Minnesota Timberwolves,96,128,-32,0,1
902,2021-04-21T00:00:00.000Z,Houston Rockets,Utah Jazz,89,112,-23,0,1
903,2021-04-01T00:00:00.000Z,LA Clippers,Denver Nuggets,94,101,-7,0,1
904,2021-05-08T00:00:00.000Z,Golden State Warriors,Oklahoma City Thunder,136,97,39,1,0
905,2021-03-12T00:00:00.000Z,New Orleans Pelicans,Cleveland Cavaliers,116,78,38,1,0
906,2021-03-24T00:00:00.000Z,San Antonio Spurs,LA Clippers,101,134,-33,0,1
907,2021-04-28T00:00:00.000Z,New York Knicks,Chicago Bulls,113,94,19,1,0
908,2021-03-19T00:00:00.000Z,Memphis Grizzlies,Golden State Warriors,103,116,-13,0,1
909,2021-04-14T00:00:00.000Z,New Orleans Pelicans,New York Knicks,106,116,-10,0,1
910,2021-04-02T00:00:00.000Z,New Orleans Pelicans,Atlanta Hawks,103,126,-23,0,1
911,2021-04-16T00:00:00.000Z,San Antonio Spurs,Portland Trail Blazers,106,107,-1,0,1
912,2021-03-11T00:00:00.000Z,Oklahoma City Thunder,Dallas Mavericks,116,108,8,1,0
913,2021-03-16T00:00:00.000Z,Los Angeles Lakers,Minnesota Timberwolves,137,121,16,1,0
914,2021-05-02T00:00:00.000Z,San Antonio Spurs,Philadelphia 76ers,111,113,-2,0,1
915,2021-03-29T00:00:00.000Z,Houston Rockets,Memphis Grizzlies,110,120,-10,0,1
916,2021-04-30T00:00:00.000Z,Brooklyn Nets,Portland Trail Blazers,109,128,-19,0,1
917,2021-05-13T00:00:00.000Z,Atlanta Hawks,Orlando Magic,116,93,23,1,0
918,2021-03-26T00:00:00.000Z,Toronto Raptors,Phoenix Suns,100,104,-4,0,1
919,2021-03-31T00:00:00.000Z,Minnesota Timberwolves,New York Knicks,102,101,1,1,0
920,2021-03-15T00:00:00.000Z,Denver Nuggets,Indiana Pacers,121,106,15,1,0
921,2021-04-18T00:00:00.000Z,Orlando Magic,Houston Rockets,110,114,-4,0,1
922,2021-03-17T00:00:00.000Z,Cleveland Cavaliers,Boston Celtics,117,110,7,1,0
923,2021-04-11T00:00:00.000Z,Minnesota Timberwolves,Chicago Bulls,121,117,4,1,0
924,2021-04-09T00:00:00.000Z,Golden State Warriors,Washington Wizards,107,110,-3,0,1
925,2021-03-14T00:00:00.000Z,Houston Rockets,Boston Celtics,107,134,-27,0,1
926,2021-05-11T00:00:00.000Z,Indiana Pacers,Philadelphia 76ers,103,94,9,1,0
927,2021-03-27T00:00:00.000Z,Utah Jazz,Memphis Grizzlies,126,110,16,1,0
928,2021-04-19T00:00:00.000Z,Milwaukee Bucks,Phoenix Suns,127,128,-1,0,1
929,2021-03-13T00:00:00.000Z,Atlanta Hawks,Sacramento Kings,121,106,15,1,0
930,2021-05-15T00:00:00.000Z,San Antonio Spurs,Phoenix Suns,103,140,-37,0,1
931,2021-03-25T00:00:00.000Z,New York Knicks,Washington Wizards,106,102,4,1,0
932,2021-04-27T00:00:00.000Z,Charlotte Hornets,Milwaukee Bucks,104,114,-10,0,1
933,2021-04-12T00:00:00.000Z,Phoenix Suns,Houston Rockets,126,120,6,1,0
934,2021-03-21T00:00:00.000Z,New York Knicks,Philadelphia 76ers,100,101,-1,0,1
935,2021-05-09T00:00:00.000Z,Boston Celtics,Miami Heat,124,130,-6,0,1
936,2021-04-07T00:00:00.000Z,Phoenix Suns,Utah Jazz,117,113,4,1,0
937,2021-04-17T00:00:00.000Z,Washington Wizards,Detroit Pistons,121,100,21,1,0
938,2021-05-07T00:00:00.000Z,Phoenix Suns,New York Knicks,128,105,23,1,0
939,2021-04-29T00:00:00.000Z,Denver Nuggets,Toronto Raptors,121,111,10,1,0
940,2021-05-03T00:00:00.000Z,Chicago Bulls,Philadelphia 76ers,94,106,-12,0,1
941,2021-05-01T00:00:00.000Z,Minnesota Timberwolves,New Orleans Pelicans,136,140,-4,0,1
942,2021-05-14T00:00:00.000Z,Dallas Mavericks,Toronto Raptors,114,110,4,1,0
943,2021-05-16T00:00:00.000Z,Detroit Pistons,Miami Heat,107,120,-13,0,1
944,2021-05-04T00:00:00.000Z,Oklahoma City Thunder,Sacramento Kings,99,103,-4,0,1
945,2021-05-16T00:00:00.000Z,Sacramento Kings,Utah Jazz,99,121,-22,0,1
946,2021-05-12T00:00:00.000Z,Utah Jazz,Portland Trail Blazers,98,105,-7,0,1
947,2021-04-26T00:00:00.000Z,Denver Nuggets,Memphis Grizzlies,120,96,24,1,0
948,2021-05-10T00:00:00.000Z,Atlanta Hawks,Washington Wizards,125,124,1,1,0
949,2021-03-31T00:00:00.000Z,Los Angeles Lakers,Milwaukee Bucks,97,112,-15,0,1
950,2021-04-12T00:00:00.000Z,New York Knicks,Los Angeles Lakers,111,96,15,1,0
951,2021-04-22T00:00:00.000Z,Orlando Magic,New Orleans Pelicans,100,135,-35,0,1
952,2021-03-11T00:00:00.000Z,Portland Trail Blazers,Phoenix Suns,121,127,-6,0,1
953,2021-05-11T00:00:00.000Z,Memphis Grizzlies,Dallas Mavericks,133,104,29,1,0
954,2021-03-18T00:00:00.000Z,Atlanta Hawks,Oklahoma City Thunder,116,93,23,1,0
955,2021-04-09T00:00:00.000Z,Denver Nuggets,San Antonio Spurs,121,119,2,1,0
956,2021-04-05T00:00:00.000Z,Houston Rockets,Phoenix Suns,130,133,-3,0,1
957,2021-04-18T00:00:00.000Z,LA Clippers,Minnesota Timberwolves,124,105,19,1,0
958,2021-04-23T00:00:00.000Z,Charlotte Hornets,Cleveland Cavaliers,108,102,6,1,0
959,2021-03-21T00:00:00.000Z,Portland Trail Blazers,Dallas Mavericks,92,132,-40,0,1
960,2021-03-19T00:00:00.000Z,Houston Rockets,Detroit Pistons,100,113,-13,0,1
961,2021-05-12T00:00:00.000Z,Brooklyn Nets,San Antonio Spurs,128,116,12,1,0
962,2021-04-20T00:00:00.000Z,New Orleans Pelicans,Brooklyn Nets,129,134,-5,0,1
963,2021-03-13T00:00:00.000Z,Minnesota Timberwolves,Portland Trail Blazers,121,125,-4,0,1
964,2021-03-24T00:00:00.000Z,Oklahoma City Thunder,Memphis Grizzlies,107,116,-9,0,1
965,2021-03-22T00:00:00.000Z,Minnesota Timberwolves,Oklahoma City Thunder,103,112,-9,0,1
966,2021-04-03T00:00:00.000Z,Washington Wizards,Dallas Mavericks,87,109,-22,0,1
967,2021-05-15T00:00:00.000Z,Minnesota Timberwolves,Boston Celtics,108,124,-16,0,1
968,2021-04-15T00:00:00.000Z,Phoenix Suns,Sacramento Kings,122,114,8,1,0
969,2021-03-17T00:00:00.000Z,Denver Nuggets,Charlotte Hornets,129,104,25,1,0
970,2021-05-07T00:00:00.000Z,Sacramento Kings,San Antonio Spurs,104,113,-9,0,1
971,2021-04-16T00:00:00.000Z,Washington Wizards,New Orleans Pelicans,117,115,2,1,0
972,2021-03-14T00:00:00.000Z,Chicago Bulls,Toronto Raptors,118,95,23,1,0
973,2021-03-12T00:00:00.000Z,Washington Wizards,Philadelphia 76ers,101,127,-26,0,1
974,2021-03-29T00:00:00.000Z,Golden State Warriors,Chicago Bulls,116,102,14,1,0
975,2021-05-16T00:00:00.000Z,Chicago Bulls,Milwaukee Bucks,118,112,6,1,0
976,2021-05-16T00:00:00.000Z,Portland Trail Blazers,Denver Nuggets,132,116,16,1,0
977,2021-04-06T00:00:00.000Z,Toronto Raptors,Los Angeles Lakers,101,110,-9,0,1
978,2021-04-19T00:00:00.000Z,Detroit Pistons,Cleveland Cavaliers,109,105,4,1,0
979,2021-04-04T00:00:00.000Z,Boston Celtics,Charlotte Hornets,116,86,30,1,0
980,2021-04-26T00:00:00.000Z,Minnesota Timberwolves,Utah Jazz,105,104,1,1,0
981,2021-04-07T00:00:00.000Z,Denver Nuggets,San Antonio Spurs,106,96,10,1,0
982,2021-03-25T00:00:00.000Z,Los Angeles Lakers,Philadelphia 76ers,101,109,-8,0,1
983,2021-04-30T00:00:00.000Z,Los Angeles Lakers,Sacramento Kings,106,110,-4,0,1
984,2021-04-02T00:00:00.000Z,Sacramento Kings,Los Angeles Lakers,94,115,-21,0,1
985,2021-05-08T00:00:00.000Z,Philadelphia 76ers,Detroit Pistons,118,104,14,1,0
986,2021-03-26T00:00:00.000Z,Orlando Magic,Portland Trail Blazers,105,112,-7,0,1
987,2021-05-09T00:00:00.000Z,LA Clippers,New York Knicks,100,106,-6,0,1
988,2021-04-14T00:00:00.000Z,Oklahoma City Thunder,Golden State Warriors,109,147,-38,0,1
989,2021-04-21T00:00:00.000Z,Washington Wizards,Golden State Warriors,118,114,4,1,0
990,2021-04-21T00:00:00.000Z,Portland Trail Blazers,Denver Nuggets,105,106,-1,0,1
991,2021-05-01T00:00:00.000Z,Dallas Mavericks,Washington Wizards,125,124,1,1,0
992,2021-04-11T00:00:00.000Z,Portland Trail Blazers,Miami Heat,98,107,-9,0,1
993,2021-05-14T00:00:00.000Z,Golden State Warriors,New Orleans Pelicans,125,122,3,1,0
994,2021-04-28T00:00:00.000Z,Sacramento Kings,Utah Jazz,105,154,-49,0,1
995,2021-04-11T00:00:00.000Z,Charlotte Hornets,Atlanta Hawks,101,105,-4,0,1
996,2021-03-26T00:00:00.000Z,Milwaukee Bucks,Boston Celtics,114,122,-8,0,1
997,2021-05-03T00:00:00.000Z,Atlanta Hawks,Portland Trail Blazers,123,114,9,1,0
998,2021-03-13T00:00:00.000Z,Brooklyn Nets,Detroit Pistons,100,95,5,1,0
999,2021-03-16T00:00:00.000Z,Philadelphia 76ers,New York Knicks,99,96,3,1,0
1000,2021-03-21T00:00:00.000Z,Cleveland Cavaliers,Toronto Raptors,116,105,11,1,0
1001,2021-04-14T00:00:00.000Z,Chicago Bulls,Orlando Magic,106,115,-9,0,1
1002,2021-04-09T00:00:00.000Z,LA Clippers,Houston Rockets,126,109,17,1,0
1003,2021-04-10T00:00:00.000Z,Brooklyn Nets,Los Angeles Lakers,101,126,-25,0,1
1004,2021-03-23T00:00:00.000Z,New York Knicks,Washington Wizards,131,113,18,1,0
1005,2021-05-11T00:00:00.000Z,Los Angeles Lakers,New York Knicks,101,99,2,1,0
1006,2021-03-17T00:00:00.000Z,Detroit Pistons,Toronto Raptors,116,112,4,1,0
1007,2021-03-27T00:00:00.000Z,Sacramento Kings,Cleveland Cavaliers,100,98,2,1,0
1008,2021-05-02T00:00:00.000Z,Dallas Mavericks,Sacramento Kings,99,111,-12,0,1
1009,2021-04-13T00:00:00.000Z,Charlotte Hornets,Los Angeles Lakers,93,101,-8,0,1
1010,2021-03-24T00:00:00.000Z,Houston Rockets,Charlotte Hornets,97,122,-25,0,1
1011,2021-03-22T00:00:00.000Z,Houston Rockets,Toronto Raptors,117,99,18,1,0
1012,2021-03-14T00:00:00.000Z,Oklahoma City Thunder,Memphis Grizzlies,128,122,6,1,0
1013,2021-03-24T00:00:00.000Z,Sacramento Kings,Atlanta Hawks,110,108,2,1,0
1014,2021-03-12T00:00:00.000Z,Los Angeles Lakers,Indiana Pacers,105,100,5,1,0
1015,2021-03-19T00:00:00.000Z,Miami Heat,Indiana Pacers,110,137,-27,0,1
1016,2021-03-18T00:00:00.000Z,New York Knicks,Orlando Magic,94,93,1,1,0
1017,2021-04-16T00:00:00.000Z,Brooklyn Nets,Charlotte Hornets,130,115,15,1,0
1018,2021-03-29T00:00:00.000Z,Boston Celtics,New Orleans Pelicans,109,115,-6,0,1
1019,2021-03-28T00:00:00.000Z,Toronto Raptors,Portland Trail Blazers,117,122,-5,0,1
1020,2021-05-01T00:00:00.000Z,Charlotte Hornets,Detroit Pistons,107,94,13,1,0
1021,2021-03-15T00:00:00.000Z,Washington Wizards,Milwaukee Bucks,122,133,-11,0,1
1022,2021-05-10T00:00:00.000Z,Cleveland Cavaliers,Indiana Pacers,102,111,-9,0,1
1023,2021-05-15T00:00:00.000Z,Brooklyn Nets,Chicago Bulls,105,91,14,1,0
1024,2021-03-25T00:00:00.000Z,Miami Heat,Portland Trail Blazers,122,125,-3,0,1
1025,2021-04-18T00:00:00.000Z,Miami Heat,Brooklyn Nets,109,107,2,1,0
1026,2021-04-17T00:00:00.000Z,Phoenix Suns,San Antonio Spurs,85,111,-26,0,1
1027,2021-03-31T00:00:00.000Z,Phoenix Suns,Chicago Bulls,121,116,5,1,0
1028,2021-04-19T00:00:00.000Z,Philadelphia 76ers,Golden State Warriors,96,107,-11,0,1
1029,2021-04-25T00:00:00.000Z,Charlotte Hornets,Boston Celtics,125,104,21,1,0
1030,2021-04-20T00:00:00.000Z,Atlanta Hawks,Orlando Magic,112,96,16,1,0
1031,2021-04-26T00:00:00.000Z,Orlando Magic,Los Angeles Lakers,103,114,-11,0,1
1032,2021-04-21T00:00:00.000Z,Cleveland Cavaliers,Chicago Bulls,121,105,16,1,0
1033,2021-04-02T00:00:00.000Z,Toronto Raptors,Golden State Warriors,130,77,53,1,0
1034,2021-04-24T00:00:00.000Z,Indiana Pacers,Detroit Pistons,115,109,6,1,0
1035,2021-04-22T00:00:00.000Z,Chicago Bulls,Charlotte Hornets,108,91,17,1,0
1036,2021-04-27T00:00:00.000Z,Indiana Pacers,Portland Trail Blazers,112,133,-21,0,1
1037,2021-04-23T00:00:00.000Z,Brooklyn Nets,Boston Celtics,109,104,5,1,0
1038,2021-04-28T00:00:00.000Z,Cleveland Cavaliers,Orlando Magic,104,109,-5,0,1
1039,2021-04-29T00:00:00.000Z,Detroit Pistons,Dallas Mavericks,105,115,-10,0,1
1040,2021-04-30T00:00:00.000Z,Chicago Bulls,Milwaukee Bucks,98,108,-10,0,1
1041,2021-05-09T00:00:00.000Z,Los Angeles Lakers,Phoenix Suns,123,110,13,1,0
1042,2021-05-08T00:00:00.000Z,Toronto Raptors,Memphis Grizzlies,99,109,-10,0,1
1043,2021-05-14T00:00:00.000Z,Detroit Pistons,Denver Nuggets,91,104,-13,0,1
1044,2021-05-05T00:00:00.000Z,Indiana Pacers,Sacramento Kings,93,104,-11,0,1
1045,2021-05-13T00:00:00.000Z,Indiana Pacers,Milwaukee Bucks,133,142,-9,0,1
1046,2021-05-04T00:00:00.000Z,Cleveland Cavaliers,Phoenix Suns,118,134,-16,0,1
1047,2021-05-16T00:00:00.000Z,Washington Wizards,Charlotte Hornets,115,110,5,1,0
1048,2021-05-16T00:00:00.000Z,Minnesota Timberwolves,Dallas Mavericks,136,121,15,1,0
1049,2021-05-12T00:00:00.000Z,Atlanta Hawks,Washington Wizards,120,116,4,1,0
1050,2021-04-01T00:00:00.000Z,San Antonio Spurs,Atlanta Hawks,129,134,-5,0,1
1051,2021-04-15T00:00:00.000Z,Atlanta Hawks,Milwaukee Bucks,109,120,-11,0,1
1052,2021-03-24T00:00:00.000Z,Minnesota Timberwolves,Dallas Mavericks,108,128,-20,0,1
1053,2021-03-18T00:00:00.000Z,Los Angeles Lakers,Charlotte Hornets,116,105,11,1,0
1054,2021-05-01T00:00:00.000Z,Orlando Magic,Memphis Grizzlies,112,111,1,1,0
1055,2021-03-31T00:00:00.000Z,Oklahoma City Thunder,Toronto Raptors,113,103,10,1,0
1056,2021-03-17T00:00:00.000Z,Washington Wizards,Sacramento Kings,119,121,-2,0,1
1057,2021-03-22T00:00:00.000Z,Milwaukee Bucks,Indiana Pacers,140,113,27,1,0
1058,2021-04-11T00:00:00.000Z,Memphis Grizzlies,Indiana Pacers,125,132,-7,0,1
1059,2021-05-07T00:00:00.000Z,Dallas Mavericks,Cleveland Cavaliers,110,90,20,1,0
1060,2021-03-16T00:00:00.000Z,Miami Heat,Cleveland Cavaliers,113,98,15,1,0
1061,2021-05-11T00:00:00.000Z,Detroit Pistons,Minnesota Timberwolves,100,119,-19,0,1
1062,2021-04-28T00:00:00.000Z,Phoenix Suns,LA Clippers,109,101,8,1,0
1063,2021-04-14T00:00:00.000Z,Detroit Pistons,LA Clippers,98,100,-2,0,1
1064,2021-03-15T00:00:00.000Z,Dallas Mavericks,LA Clippers,99,109,-10,0,1
1065,2021-04-14T00:00:00.000Z,Sacramento Kings,Washington Wizards,111,123,-12,0,1
1066,2021-03-13T00:00:00.000Z,Oklahoma City Thunder,New York Knicks,97,119,-22,0,1
1067,2021-03-19T00:00:00.000Z,Toronto Raptors,Utah Jazz,112,115,-3,0,1
1068,2021-03-14T00:00:00.000Z,Orlando Magic,Miami Heat,97,102,-5,0,1
1069,2021-04-12T00:00:00.000Z,Minnesota Timberwolves,Brooklyn Nets,97,127,-30,0,1
1070,2021-04-13T00:00:00.000Z,Phoenix Suns,Miami Heat,106,86,20,1,0
1071,2021-03-12T00:00:00.000Z,Utah Jazz,Houston Rockets,114,99,15,1,0
1072,2021-04-04T00:00:00.000Z,Houston Rockets,New Orleans Pelicans,115,122,-7,0,1
1073,2021-05-03T00:00:00.000Z,Memphis Grizzlies,New York Knicks,104,118,-14,0,1
1074,2021-03-26T00:00:00.000Z,Golden State Warriors,Atlanta Hawks,108,124,-16,0,1
1075,2021-04-21T00:00:00.000Z,New York Knicks,Atlanta Hawks,137,127,10,1,0
1076,2021-05-09T00:00:00.000Z,Detroit Pistons,Chicago Bulls,96,108,-12,0,1
1077,2021-03-29T00:00:00.000Z,Detroit Pistons,Toronto Raptors,118,104,14,1,0
1078,2021-04-03T00:00:00.000Z,San Antonio Spurs,Indiana Pacers,133,139,-6,0,1
1079,2021-03-21T00:00:00.000Z,Detroit Pistons,Chicago Bulls,86,100,-14,0,1
1080,2021-04-30T00:00:00.000Z,Cleveland Cavaliers,Washington Wizards,93,122,-29,0,1
1081,2021-04-05T00:00:00.000Z,Brooklyn Nets,New York Knicks,114,112,2,1,0
1082,2021-04-08T00:00:00.000Z,Miami Heat,Los Angeles Lakers,110,104,6,1,0
1083,2021-03-27T00:00:00.000Z,Oklahoma City Thunder,Boston Celtics,94,111,-17,0,1
1084,2021-05-04T00:00:00.000Z,LA Clippers,Toronto Raptors,105,100,5,1,0
1085,2021-04-02T00:00:00.000Z,Indiana Pacers,Charlotte Hornets,97,114,-17,0,1
1086,2021-04-19T00:00:00.000Z,Washington Wizards,Oklahoma City Thunder,119,107,12,1,0
1087,2021-04-16T00:00:00.000Z,Philadelphia 76ers,LA Clippers,106,103,3,1,0
1088,2021-05-06T00:00:00.000Z,LA Clippers,Los Angeles Lakers,118,94,24,1,0
1089,2021-04-07T00:00:00.000Z,Boston Celtics,New York Knicks,101,99,2,1,0
1090,2021-05-02T00:00:00.000Z,Oklahoma City Thunder,Phoenix Suns,120,123,-3,0,1
1091,2021-04-09T00:00:00.000Z,New York Knicks,Memphis Grizzlies,133,129,4,1,0
1092,2021-04-29T00:00:00.000Z,Minnesota Timberwolves,Golden State Warriors,126,114,12,1,0
1093,2021-04-17T00:00:00.000Z,Milwaukee Bucks,Memphis Grizzlies,115,128,-13,0,1
1094,2021-05-08T00:00:00.000Z,Portland Trail Blazers,San Antonio Spurs,124,102,22,1,0
1095,2021-04-26T00:00:00.000Z,New Orleans Pelicans,LA Clippers,120,103,17,1,0
1096,2021-05-16T00:00:00.000Z,Philadelphia 76ers,Orlando Magic,128,117,11,1,0
1097,2021-05-10T00:00:00.000Z,Portland Trail Blazers,Houston Rockets,140,129,11,1,0
1098,2021-04-10T00:00:00.000Z,Utah Jazz,Sacramento Kings,128,112,16,1,0
1099,2021-03-14T00:00:00.000Z,Philadelphia 76ers,San Antonio Spurs,134,99,35,1,0
1100,2021-03-23T00:00:00.000Z,New Orleans Pelicans,Los Angeles Lakers,128,111,17,1,0
1101,2021-05-11T00:00:00.000Z,Toronto Raptors,LA Clippers,96,115,-19,0,1
1102,2021-03-24T00:00:00.000Z,Toronto Raptors,Denver Nuggets,135,111,24,1,0
1103,2021-05-03T00:00:00.000Z,New Orleans Pelicans,Golden State Warriors,108,123,-15,0,1
1104,2021-03-16T00:00:00.000Z,Portland Trail Blazers,New Orleans Pelicans,125,124,1,1,0
1105,2021-04-30T00:00:00.000Z,Philadelphia 76ers,Atlanta Hawks,126,104,22,1,0
1106,2021-04-22T00:00:00.000Z,Dallas Mavericks,Los Angeles Lakers,115,110,5,1,0
1107,2021-03-25T00:00:00.000Z,Sacramento Kings,Golden State Warriors,141,119,22,1,0
1108,2021-04-09T00:00:00.000Z,Milwaukee Bucks,Charlotte Hornets,119,127,-8,0,1
1109,2021-03-26T00:00:00.000Z,Detroit Pistons,Brooklyn Nets,111,113,-2,0,1
1110,2021-03-27T00:00:00.000Z,Milwaukee Bucks,New York Knicks,96,102,-6,0,1
1111,2021-03-28T00:00:00.000Z,Charlotte Hornets,Phoenix Suns,97,101,-4,0,1
